大事	だいじ, おおごと	important; valuable; serious matter
両方	りょうほう	both
技術	ぎじゅつ	technology; engineering<br/>technique; skill<br/>art; craft
経験	けいけん	experience
技術者	ぎじゅつしゃ	engineer; technical expert
必要	ひつよう	need; necessity
絶対	ぜったい	absolute; absolutely
社長	しゃちょう	president (of a company); manager; director
無理	むり	impossible; forced; overdoing
朝ご飯	あさごはん	breakfast
埋め合わせ	うめあわせ	compensation
全然	ぜんぜん	wholly; not at all (with negative)
実践	じっせん	practice; put into practice
文法	ぶんぽう	grammar
思い出す	おもいだす	to recall; to remember; to recollect<br/>to remind of; to call to mind
終わる	おわる	to finish; to end; to close
君	きみ,くん	you; name suffix for boys
試す	ためす	to attempt; to test
鋭い	するどい	pointed; sharp
思う	おもう	to think
住む	すむ	to live; reside
一生懸命	いっしょうけんめい	with all one's might; with utmost effort; very hard
演奏	えんそう	musical performance
卒業	そつぎょう	graduation
落とす	おとす	to drop; to lose; to remove
調子	ちょうし	tone; condition
可笑しい	おかしい	funny; amusing; strange; peculiar
捕まえる	つかまえる	to arrest; to catch; to seize
掴む	つかむ	to grip; to grab; to catch hold of
運転	うんてん	drive
運転免許	うんてんめんきょ	driver's license
親	おや	parent(s)
海外旅行	かいがいりょこう	trip to a foreign country
地震	じしん	earthquake
地震学	じしんがく	seismology
興味	きょうみ	interest (in something)
無事	ぶじ	safely; peacefully
願う	ねがう	to wish; to ask a favor; to apply for
歌詞	かし	song lyrics
簡単	かんたん	simple; easy
～年代	～ねんだい	~ties (as in "the sixties")
場合	ばあい	case; situation
可能性	かのうせい	potentiality; likelihood; possibility; availability
含まれる	ふくまれる	be included (in something)
添削	てんさく	correction
専門家	せんもんか	specialist; expert
韓国料理	かんこくりょうり	Korean food
命	いのち	life
壊す	こわす	to break; to destroy; to smash
心臓	しんぞう	heart (organ)
瞬間	しゅんかん	instant; moment
払う	はらう	to pay; to brush off; to dispose of
美味しい	おいしい	tasty
趣味	しゅみ	hobby; interest
薬	くすり	medicine; drug; remedy; chemical
身長	しんちょう	stature; height
合格	ごうかく	passing an examination; eligibility
不合格	ふごうかく	failure; disqualification
勘弁	かんべん	pardon; forgiveness; forbearance
動物園	どうぶつえん	zoo
笑顔	えがお	smiling face; smile
言い訳	いいわけ	apology; excuse
恥ずかしい	はずかしい	shy; ashamed; embarassed
恥ずかしがり屋	はずかしがりや	shy person
易しい	やさしい	easy; simple
優しい	やさしい	gentle; kindhearted
約束	やくそく	promise; agreement; contract; pact
守る	まもる	to protect; to guard; to defend; to keep (a promise); to abide (by the rules)
約束を守る	やくそくをまもる	keep a promise
式場	しきじょう	ceremonial hall; place of ceremony (e.g. marriage)
自動車学校	じどうしゃがっこう	driving school
通う	かよう	to go to and from (a place); to go back and forth between; to run between (e.g. bus, train, etc.); to go to (school, work, etc.); to circulate (e.g. blood, electricity)
調べる	しらべる	investigate; check
最近	さいきん	lately; recently
数学	すうがく	mathematics
数学者	すうがくしゃ	mathematician
足る	たる	be sufficient; be enough
物足りない	ものたりない	unsatisfied; unsatisfactory
出発	しゅっぱつ	departure
出発時間	しゅっぱつじかん	starting (departure) time
到着	とうちゃく	arrival
到着時刻	とうちゃくじこく	arrival time
賑やか	にぎやか	lively; exciting
二日酔	ふつかよい	hangover
真っ直ぐ	まっすぐ	dead straight; honestly
沢山	たくさん	a lot; plenty
喋る	しゃべる	chat; talk
心	こころ	heart; mind
幸せ	しあわせ	happiness; good fortune
戻る	もどる	to return (to a place); turn back
朝飯	あさめし, あさはん	breakfast
出身	しゅっしん	person's origin
ご飯	ごはん	rice; food; meal
焼き鳥	やきとり	grilled chicken on skewer
焼肉	やきにく	yakiniku (Japanese dish of fried meat), Korean barbecue
風邪薬	かぜぐすり	remedy for a cold
寿司	すし	sushi
下らない	くだらない	pointless; worthless; insignificant; good-for-nothing; stupid
詰まらない	つまらない	dull; uninteresting; boring; tedious
事務所	じむしょ	office; one's place of business
息子	むすこ	son
娘	むすめ	daughter; girl
勿論	もちろん	of course; no doubt
妻	つま	wife
大抵	たいてい	generally; mostly; usually
試合	しあい	match; game
負ける	まける	to lose, to be defeated
素敵	すてき	lovely; nice
美術館	びじゅつかん	art museum; art gallery
展覧会	てんらんかい	exhibition
作品	さくひん	work of art; piece
下さい	ください	please; give me...
偶に	たまに	occasionally; once in a while
終電	しゅうでん	last train
終電車	しゅうでんしゃ	last train
申す	もうす	to be called; to say (humble)
息子さん	むすこさん	son (respectful)
娘さん	むすめさん	daughter; young woman
家内	かない	(my) wife
奥さん	おくさん	(someone else's) wife; married lady
得意	とくい	triumph; prosperity; pride; one's strong point
苦手	にがて	poor (at); weak (in); not very good (at); dislike (of)
試験	しけん	test; examination
心配	しんぱい	worry; concern; anxiety; assistance
浴衣	ゆかた	yukata; informal summer kimono
電池	でんち	battery
扇子	せんす	paper fan
人形	にんぎょう	doll
時計	とけい	clock; watch
足	あし	leg; foot
林檎	りんご	apple
携帯	けいたい	cell phone; portable; carry
朝寝坊	あさねぼう	oversleep
誕生日	たんじょうび	birthday
用事	ようじ	things to do; errand; business
ご存じ	ごぞんじ	know (honorific)
信号	しんごう	signal; traffic light
バス停	バスてい	bus stop
劇場	げきじょう	theater
博物館	はくぶつかん	museum
名刺	めいし	business card; calling card
道	みち	road; street
歩道橋	ほどうきょう	pedestrian bridge
横断歩道	おうだんほどう	pedestrian crossing; crosswalk
折り紙	おりがみ	origami; paper folding
反対	はんたい	opposition; contrast; opposite
離婚	りこん	divorce
美しい	うつくしい	beautiful
真面目	まじめ	serious; sober; earnest
普通	ふつう	normal; regular; general; ordinary
肩	かた	shoulder
四角い	しかくい	square; four-sided
髪	かみ	hair; hairstyle
金髪	きんぱつ	blond; blonde
喉	のど	throat
素晴らしい	すばらしい	splendid; excellent
不愉快	ふゆかい	unpleasant; disagreeable
出張	しゅっちょう	business trip; official tour
最初	さいしょ	beginning; outset; first; onset
以上	いじょう	not less than; ... and more; ... and upwards
数字	すうじ	numeral; figure; digit; numeric character
新幹線	しんかんせん	Shinkansen; Bullet Train
中止	ちゅうし	suspension, stoppage, discontinuance, interruption
大阪	おおさか	Osaka (place name)
霧	きり	fog; mist
片道	かたみち	one way
片道切符	かたみちきっぷ	one-way ticket
往復	おうふく	going and returning; round trip
往復切符	おうふくきっぷ	round-trip ticket; return ticket
同僚	どうりょう	colleague; coworker
季節	きせつ	season
霊	れい	soul; spirit; departed soul; ghost
気温	きおん	atmospheric temperature
余裕	よゆう	surplus; room; leeway
作家	さっか	author; writer; novelist; artist
警察官	けいさつかん	police officer
消防士	しょうぼうし	firefighter
将来	しょうらい	future; in the future
世界	せかい	world
予報	よほう	forecast; prediction
天気予報	てんきよほう	weather forecast
秒	びょう	second (interval of time)
漫画	まんが	manga; comics
和食	わしょく	Japanese-style food
例えば	たとえば	for example
殆ど	ほとんど	mostly; nearly; practically; almost
週末	しゅうまつ	weekend
今週末	こんしゅうまつ	this weekend
平日	へいじつ	weekday; ordinary days (i.e. non-holiday)
失礼	しつれい	discourtesy; impoliteness; to be rude; to leave; Excuse me; Goodbye
御苦労	ごくろう	trouble (I have put you through)
御苦労様	ごくろうさま	thank you very much for your..., I appreciate your efforts
僕	ぼく	I (generally male)
迎え	むかえ	greeting; meeting
迎える	むかえる	to welcome; to greet; to go out to meet
生活	せいかつ	life; living
お風呂	おふろ	bath
予約	よやく	reservation; appointment
説明	せつめい	explanation; description
規則	きそく	rules; regulations
女性	じょせい	woman; female
男性	だんせい	male; man
別	べつ	another; different
別々	べつべつ	separately
職員室	しょくいんしつ	staff room
選ぶ	えらぶ	choose; elect
決める	きめる	to decide; to choose; to make up one's mind; to agree upon
門限	もんげん	closing time; lockup; curfew
探す	さがす	search for; look for
残念	ざんねん	regret; bad luck; disappointment
転勤	てんきん	job transfer
見つける	みつける	to find (by looking); to discover; to locate; to come across; to detect; to spot
行う	おこなう	do; carry out
赤ちゃん	あかちゃん	baby, infant
どうやら	どうやら	it seems like; it appears that; somehow or another
思える	おもえる	to seem; to appear likely
持てる	もてる	be popular (with)
受ける	うける	to receive; to get; to catch (e.g. a ball); to be struck by (wind, waves, sunlight, etc.); to take (a test, an interview); to accept
突然	とつぜん	abruptly; suddenly
営業	えいぎょう	business; sales
部長	ぶちょう	section chief; department head
教科書	きょうかしょ	textbook; schoolbook
動詞	どうし	verb
削る	けずる	grind down; trim; scale back
進む	すすむ	to advance; move forward
客	きゃく	visitor; customer
お客様	おきゃくさま	customer; guest
追加	ついか	addition; supplement; append
謙遜	けんそん	humility; modesty
会議	かいぎ	conference; meeting
会議室	かいぎしつ	meeting room; conference room
出席	しゅっせき	attendance; presence
連絡	れんらく	connection; communication
考える	かんがえる	to consider; to think about
記事	きじ	article; story
完璧	かんぺき	perfection; perfect
解釈	かいしゃく	interpretation; explanation
届く	とどく	to reach; to be received
銀河	ぎんが	Milky Way; galaxy
学ぶ	まなぶ	to learn; to study
心温まる	こころあたたまる	to be heart-warming
梅雨	つゆ,ばいう	rainy season
最悪	さいあく	the worst
蝶	ちょう	butterfly
国内	こくない	domestic; internal
気持ち	きもち	feeling; sensation; mood<br/>preparedness; readiness; attitude<br/>thanks; solicitude; sympathy<br/>just a little; somewhat; slightly
値段	ねだん	price
半ば	なかば	middle; halfway
最善	さいぜん	the very best
最高	さいこう	maximum; supreme
梅雨明け	つゆあけ	end of the rainy season
梅雨入り	つゆいり	start of the rainy season
落ちる	おちる	to fall; to drop; to fail (e.g. exam)
行	ぎょう	line (i.e. text); row
空ける	あける	empty; clear out
内	うち	inside
手伝う	てつだう	help; assist
送る	おくる	to send (a thing); to dispatch; to escort (a person somewhere); to see off; to bid farewell
列	れつ	row; line
電気屋	でんきや	electric appliance store
急	きゅう	urgent; dire; pressing
是非	ぜひ	by all means; at any cost
是非共	ぜひとも	by all means (with sense of not taking "no" for an answer)
平気	へいき	nonchalant; calm
盛大	せいだい	grand; prosperous; magnificent
送別会	そうべつかい	farewell party
去る	さる	to go away; to leave
開く	ひらく	to open (doors, business, eyes, etc.); to be open; be available; to be empty
下さる	くださる	give; favor with (honorific)
感謝	かんしゃ	gratitude; thanks
親切	しんせつ	kind; friendly
お世話	おせわ	help; aid; assistance
お世話になる	おせわになる	receive favor; be indebted; be grateful
お正月	おしょうがつ	New Year's Day
挨拶	あいさつ	greet; greeting
元旦	がんたん	New Year's Day
年賀状	ねんがじょう	New Year's card
初詣	はつもうで	one's first visit to a shrine in the New Year
神社	じんじゃ	Shinto shrine
お年玉	おとしだま	New Year's gift
福袋	ふくぶくろ	lucky-dip bag; grab bag
皮膚	ひふ	skin
制服	せいふく	uniform
着替える	きがえる	to change one's clothes
昔	むかし	(in the) old times; the old days
正しい	ただしい	correct; righteous; lawful
大統領	だいとうりょう	president
小学校	しょうがっこう	elementary school; primary school
視察	しさつ	inspection; observation
実際	じっさい	practicality; practical; reality
教壇	きょうだん	platform
悲劇的	ひげきてき	tragic
轢く	ひく	to run over
損失	そんしつ	loss (e.g. assets or profits)
夫妻	ふさい	husband and wife; Mr. and Mrs.
撃墜	げきつい	shooting down (aircraft)
理由	りゆう	reason; pretext; motive
事故	じこ	accident; incident
手短	てみじか	short; brief
表現	ひょうげん	expression; presentation; representation; notation (Mathematics)
以下	いか	not exceeding; and downward; the below-mentioned; the following; the rest
見落とす	みおとす	miss; fail to notice
助かる	たすかる	to be saved; to be rescued; to be helpful
英語版	えいごばん	English version; non-Japanese version
能力	のうりょく	ability; capacity
判断	はんだん	judgment; decision
力	ちから	strength; power
政府	せいふ	government; administration
奨学金	しょうがくきん	scholarship; fellowship
お皿	おさら	plate; dish
工場長	こうじょうちょう	factory (works) manager
大切にする	たいせつにする	to value; to treasure; to cherish; to think a great deal of
温かい	あたたかい	warm; mild; genial
住所	じゅうしょ	address; one's dwelling
餌	えさ	bait; feed
御神籤	おみくじ	written oracle
禿げ頭	はげあたま	bald head; baldness
禿げる	はげる	to lose hair
警備員	けいびいん	guard
発音	はつおん	pronunciation
代わり	かわり	substitution
人力車	じんりきしゃ	rickshaw; jinrikisha
直す	なおす	to repair; to heal; to fix; to replace
途中	とちゅう	on the way; midway; en route
泣く	なく	to cry; to weep
何時までも	いつまでも	forever
怒る	おこる, いかる	to get angry; to get mad; to tell someone off; to scold
動く	うごく	to move
足りる	たりる	to be sufficient; to be enough
名詞	めいし	noun
辞書形	じしょけい	dictionary form
否定形	ひていけい	negative form
幼稚園	ようちえん	kindergarten
中学校	ちゅうがっこう	junior high school; middle school
順番	じゅんばん	(in) order; taking turns
続き	つづき	continuation; sequel
続ける	つづける	to continue; to keep up; to keep on
投稿	とうこう	contribution; submission; posting (e.g. to an article, newsgroup or mailing list)
言語	げんご	language; speech
検出	けんしゅつ	detection; sense (e.g. sensor)
呼び出す	よびだす	call; page
受付	うけつけ	receptionist; information desk
飛び出す	とびだす	to jump out; to fly out; to dash out
通り	とおり	avenue; street
出社	しゅっしゃ	going to work (e.g. in the morning); coming to work
返る	かえる	be restored to; return to
変える	かえる	change
代える	かえる	substitute; use in place of
転ぶ	ころぶ	to fall down; to fall over
良さげ	よさげ	good appearing; (of) good appearance
嘘	うそ	lie
吐く	はく	to spit; to vomit; to belch; to confess; to tell (lies)
嘘を吐く	うそをつく	tell a lie
奢る	おごる	to treat (someone)
指輪	ゆびわ	ring
夫	おっと	husband
残る	のこる	to remain; to be left over
引っ越し	ひっこし	moving; changing residence
やっと	やっと	at last; finally
濡れる	ぬれる	to get wet
濡らす	ぬらす	wet; moisten
助ける	たすける	to help; to save
文書	ぶんしょ, もんじょ	document; writing; letter; paperwork; note; records; archives
全て	すべて	everything; all; the whole<br/>entirely; completely; wholly; all
提供	ていきょう	offer; provide; program sponsoring;  furnishing; provisioning; supply
感じ	かんじ	feeling; impression
感じる	かんじる	to feel; to sense; to experience
ぶらぶら	ぶらぶら	wander aimlessly; hang about
街	まち	town; neighborhood; street
高速	こうそく	high speed
道路	どうろ	road; street
高速道路	こうそくどうろ	freeway; highway
登録	とうろく	registration
喜び	よろこび	joy; happiness
お疲れ様	おつかれさま	thank you; many thanks; much appreciated; that's enough for today
世直し	よなおし	world reformation
失敗	しっぱい	failure; mistake
切り替える	きりかえる	to change; to exchange; to convert; to renew; to throw a switch; to replace
丁寧語	ていねいご	polite language (i.e. masu, desu, etc.)
尊敬語	そんけいご	honorific language
謙譲語	けんじょうご	humble language (e.g. itadaku)
鉄拳	てっけん	fist
楽しむ	たのしむ	to enjoy oneself
加える	くわえる	to add; to add up; to sum up; to append; to annex
付け加える	つけくわえる	to add one thing to another
言い出す	いいだす	begin to speak
初心者	しょしんしゃ	beginner
誤る	あやまる	make a mistake
在庫	ざいこ	inventory; stock; stockpile
処分	しょぶん	disposal; dealing (with a problem); punishment; putting down (e.g. animal)
兼ねる	かねる	to serve or combine two functions; to find difficult (unpleasant, awkward, painful)
可能	かのう	possible; potential
季節外れ	きせつはずれ	unseasonable; out of season
詐欺	さぎ	swindle; con game
目的	もくてき	purpose; goal; aim; objective; intention
販売	はんばい	sale; selling
除く	のぞく	to rid of; to exclude
基本	きほん	basis; foundation
的	てき	-like; typical
基本的	きほんてき	fundamental; standard; basic
中身	なかみ	content; interior
定価	ていか	fixed price
価値	かち	value; merit
確認	かくにん	confirmation
詳しい	くわしい	detailed; full; accurate<br/>knowing very well; well-acquainted; well-informed
合計	ごうけい	sum total
金額	きんがく	amount of money; sum
消費	しょうひ	consumption; spending
消費者	しょうひしゃ	consumer
蛇足	だそく	redundancy; superfluity; useless addition
習慣	しゅうかん	custom; habit
確か	たしか	certain; sure; definite; if I remember correctly
確かに	たしかに	certainly; definitely
必ず	かならず	without exception; necessarily; certainly
必ずしも	かならずしも	(not) always; (not) necessarily
限る	かぎる	to restrict; to limit; to confine
要は	ようは	in a word; in short
に取って	にとって	to; for; concerning; as far as ... is concerned; regarding
結局	けっきょく	after all; finally
無駄	むだ	no good; pointless
付く	づく	to become (a state, condition, etc.)
品物	しなもの	goods; article; thing
直訳	ちょくやく	literal translation; direct translation
意訳	いやく	free translation; liberal translation
翻訳	ほんやく	translation
冠詞	かんし	article
概念	がいねん	general idea; concept
主人	しゅじん	head of household; master; husband; shop owner
盗む	ぬすむ	steal; rob
犯人	はんにん	criminal; offender
遅れる	おくれる	to be late
お待ち遠様	おまちどおさま	I'm sorry to have kept you waiting
吃驚	びっくり, きっきょう	to be surprised; to be amazed; to be frightened; to be astonished; surprise
駄目	だめ	useless; no good; hopeless; no
怠い	だるい	sluggish; feel heavy; languid; dull
富士山	ふじさん	Mt. Fuji
原宿	はらじゅく	Harajuku (in Tokyo)
北海道	ほっかいどう	Hokkaido prefecture (of the 道 kind) and northernmost of the main islands in Japan
本州	ほんしゅう	Honshu (island)
如何	いかが	how; what
行き成り	いきなり	all of a sudden; without warning
頂ける	いただける	to receive (potential); to be pretty good; to be exquisite; to be approvable
致す	いたす	to do (humble)
塾	じゅく	coaching school; cramming school; juku
柔道	じゅうどう	judo
壁	かべ	wall; partition
畏まりました	かしこまりました	Certainly. (accepting an order or request)
可哀相	かわいそう	poor; pitiable
屹度	きっと	surely, certainly; sternly
交換	こうかん	exchange; bartering
呉れる	くれる	to give; to let one have; to do for one; to be given (from the receiver's point of view)
九州	きゅうしゅう	Kyushu (island)
御存知	ごぞんじ	knowing (honorific); acquaintance
お陰様で	おかげさまで	Thanks to God; thanks to you
沖縄	おきなわ	Okinawa (island)
御先	おさき	going before; the future
お先に失礼します	おさきにしつれいします	excuse me for leaving early (used when leaving a workplace)
理解	りかい	understanding; comprehension
参加	さんか	participation
札幌	さっぽろ	Sapporo (city)
更に	さらに	furthermore; still more
刺身	さしみ	sashimi (sliced raw fish)
仕舞う	しまう	to finish; to put away
信じられない！	しんじられない！	Unbelievable!
新鮮	しんせん	fresh
都庁	とちょう	Tokyo Government Office
所で	ところで	by the way
兎に角	とにかく	anyhow; at any rate; anyway; somehow or other; generally speaking; in any case
取りあえず	とりあえず	at once; first of all; for the time being; for now
積もり	つもり	intention; purpose
野球	やきゅう	baseball
野球場	やきゅうじょう	baseball stadium; baseball field
前夜	ぜんや	last night; the previous night
予定	よてい	plan; schedule
宜しく	よろしく	well; properly; suitably; best regards
怪我	けが	injury
蹴る	ける	kick
さっき	さっき	some time ago; a little while ago
上る	のぼる	go up
下りる	おりる	go down; come down
儘	まま, まんま	as it is; as one likes; because; as; condition; state
熱	ねつ	heat; fever
似合う	にあう	to suit; to match well
貯金	ちょきん	savings; deposit
増える	ふえる	to increase; to accrue
丁寧	ていねい	polite; courteous; careful
歯医者	はいしゃ	dentist
咳	せき	cough
怪我をする	けがをする	to get injured
火傷	やけど	burn
火傷する	やけどする	get burned
骨	ほね	bone; frame; spirit
骨折	こっせつ	fracture; broken bone
痒い	かゆい	itchy
診察する	しんさつする	to examine
入院する	にゅういんする	to be hospitalized
検札	けんさつ	ticket check
手術	しゅじゅつ	surgical operation
手術する	しゅじゅつする	to have an operation
治る	なおる	to be cured; to get well; to be healed; to get mended
病気が治る	びょうきがなおる	recover from (sickness), get well
退院	たいいん	discharge from a hospital
退院する	たいいんする	to get out of the hospital
薬局	やっきょく	drugstore; pharmacy
錠剤	じょうざい	pill; lozenge; tablet
粉	こな,こ	powder; flour
粉薬	こなぐすり	powder medicine
塗る	ぬる	spread on; paint
塗り薬	ぬりぐすり	liniment; ointment; salve
光栄	こうえい	honour; honor; glory; privilege
存じ	ぞんじ	knowing
存じる	ぞんじる	think; know (humble form)
訂正	ていせい	correction; amendment
嬉しい	うれしい	happy; glad
気を悪くする	きをわるくする	to take offense (at); to take offence (at); to feel hurt (by)
誉める	ほめる	to praise
情報	じょうほう	information
出会う	であう	to run into (someone); to meet (someone) by chance
文化	ぶんか	culture; civilization
人生	じんせい	human life; life
起こる	おこる	to occur; to happen
購入	こうにゅう	purchase
購入する	こうにゅうする	purchase
甘える	あまえる	depend on; take advantage of
ぐだぐだ	ぐだぐだ	exhausted; tired; withered; worn out; boiling until shapeless or mushy; wordily
きちんと	きちんと	properly; neatly
伝わる	つたわる	be transmitted; be handed down
一般に	いっぱんに	generally; in general
取り急ぎ	とりいそぎ	in haste
部分	ぶぶん	part; section
頂く	いただく	to receive; to eat; to drink (humble)
消化	しょうか	digestion; consumption
消化する	しょうかする	digest
動画	どうが	animation; motion picture; moving image; video; in-betweening (in anime)
改めて	あらためて	once again
返信	へんしん	reply
件	けん	matter; case; item; affair; subject;<br/>counter for cases, matters, etc.
母語	ぼご	mother tongue; native language
存在	そんざい	existence; being
心象	しんしょう	impression
学習	がくしゅう	study; learning; learn
遠慮	えんりょ	reserve; hesitation; forethought
サボる	サボる	cut classes
記録	きろく	record; documentation
残す	のこす	to leave; to reserve; to leave undone
考察	こうさつ	consideration; inquiry; enquiry
口語	こうご	spoken language; literary style based on (modern) spoken language
堅い	かたい	hard; solid; stiff; strong; safe; stubborn
実感	じっかん	true sense; realization
思考	しこう	thought; consideration; thinking
入れ替わる	いれかわる	to change places; to relieve one another
入れ替え	いれかえ	replacement; substitution; change
入れ換える	いれかえる	to replace; to substitute; to shift; to change places
のんびり	のんびり	carefree; at leisure
不味い	まずい	awful; troublesome; unappetizing
顔写真	かおじゃしん	photographic portrait
不躾	ぶしつけ	ill-breeding; impoliteness; bad manners
斜視	しゃし	squint; strabismus
髭	ひげ	moustache; beard
本人	ほんにん	the person himself; the said person
特に	とくに	particularly; especially; specifically
当たり	あたり	hit; success
それ故に	それゆえに	and so ...; consequently; wherefore; thus
活用	かつよう	utilization; conjugation
話者	わしゃ	narrator; speaker
数	かず	number; amount
大体	だいたい	generally; mostly; nearly; approximately
東京都	とうきょうと	Tokyo prefecture (of the 都 kind or metropolitan area)
本名	ほんみょう	one's real name
値	あたい	value; worth
純	じゅん	pure; innocent; chaste
通	つう	connoisseur; authority; counter for letters, notes, documents, etc.
入力	にゅうりょく	input; (data) entry
登場	とうじょう	appearance on stage; appearance
人物	じんぶつ	character; person
登場人物	とうじょうじんぶつ	characters in a play or novel
夫婦	ふうふ	husband and wife; married couple
勝手	かって	selfish; self-centered
略す	りゃくす	abbreviate; omit
間	ま	duration of time; period; pause; room
表情	ひょうじょう	facial expression
相手	あいて	partner; other person; opponent (game)
想像	そうぞう	imagination
渋い	しぶい	bitter; astringent
直面	ちょくめん	confrontation; to face; to confront; to encounter
打つかる	ぶつかる	hit; bump into
単語表	たんごひょう	vocabulary word list
馬鹿	ばか	fool; nonsense
拙い	つたない, まずい	poor-quality; shoddy; crude; unskillful; inexpert; maladroit; inept; foolish
写す	うつす	to copy; to reproduce; to transcribe; to describe
書き写す	かきうつす	to transcribe
補足	ほそく	supplement; complement
微妙	びみょう	subtle; delicate
一まず	ひとまず	first of all
流す	ながす	to let flow; to set adrift
風貌	ふうぼう	looks; appearance
物言い	ものいい	manner of speaking; verbal argument; objection; rumor; rumour
奥深い	おくふかい, おくぶかい	profound; deep
内面	ないめん	inside; interior
にじみ出る	にじみでる	to exude; to ooze; to seep out
味わい	あじわい	flavour; flavor; meaning; significance
深さ	ふかさ	depth; profundity
褒め言葉	ほめことば	words of praise; eulogy
に対して	にたいして	towards; against; regarding; in contrast with
醸し出す	かもしだす	to engender; to bring about
換える	かえる	exchange; convert
言い換える	いいかえる	express in different words; paraphrase
喜ぶ	よろこぶ	be happy; be delighted
お世辞	おせじ	compliment; flattery
具合	ぐあい	condition; health
完全	かんぜん	perfect; complete
年齢	ねんれい	age; years
年齢層	ねんれいそう	age group; age bracket
驚く	おどろく	be surprised; be startled
お互い	おたがい	mutual; one another
恐らく	おそらく	perhaps; likely; probably; I dare say
汲む	くむ	collect; scoop up
汲み取る	くみとる	to scoop out; to pump out; to understand; to surmise
後者	こうしゃ	the latter
前者	ぜんしゃ	the former
文字通り	もじどおり	literal; literally
現す	あらわす	to show; to reveal
旅行業者	りょこうぎょうしゃ	travel agent
意思	いし	intention; purpose
医学	いがく	medical science; medicine
入院	にゅういん	hospitalization
集まる	あつまる	to gather; to collect; to get together
欧州連合	おうしゅうれんごう	European Union; EU
移民	いみん	emigration, immigration; emigrant, immigrant
手助け	てだすけ	a help
滞在	たいざい	stay (somewhere)
政治屋	せいじや	politician (esp. one who works only for their own personal gain)
政治家	せいじか	politician
国境	こっきょう	national or state border
役	やく	use; service; role
役に立つ	やくにたつ	be useful; be helpful
真	しん	truth; true; real
真ん中	まんなか	center; middle
運ぶ	はこぶ	to carry; to transport; to move
沸かす	わかす	to boil; to heat; to excite
お湯	おゆ	hot water
腕	うで	arm
天才	てんさい	genius
解く	とく	to untie; to solve; to work out; to dispel; to clear up
成績	せいせき	results; record; grades
気が合う	きがあう	to get along (with someone)
折角	せっかく	with much trouble; specially
性格	せいかく	character; personality
筈	はず	expectation that something took place, will take place or was in some state
紹介	しょうかい	introduction; presentation; referral; listing
復旧	ふっきゅう, ふくきゅう	restoration; restitution; rehabilitation
作業	さぎょう	work; operation
復旧作業	ふっきゅうさぎょう	repair work
具体的	ぐたいてき	concrete; tangible; definite; specific
失敗する	しっぱいする	fail; be unsuccessful
再起動	さいきどう	restart; reboot
状態	じょうたい	current status; condition; situation; circumstances
出荷	しゅっか	shipping; dispatch
戻す	もどす	to return; to give back
用	よう	task; things to do
前後	ぜんご	before and after; front and behind; order
逆	ぎゃく	opposite; reverse; inverse
対する	たいする	face; be in response to
に対する	にたいする	regarding; in; to; towards; with regards to
賞味	しょうみ	relish; gusto; appreciation
期限	きげん	time limit; term
賞味期限	しょうみきげん	best if eaten by this date
袋	ふくろ	bag; sack
記載	きさい	record; statement; description; mention; listing; registration; booking; entry
記載する	きさいする	to record; to print; to mention
居る	おる	be present; stay (humble)
開封	かいふう	unsealed letter; breaking the seal
風味	ふうみ	taste; flavor; flavour
損なう	そこなう	to harm; to hurt; to injure; to damage; to fail in doing
早めに	はやめに	ahead of time; earlier (than usual)
召し	めし	summons; call
上がる	あがる	rise; go up; improve; be completed; give profit/income
召し上がる	めしあがる	eat; drink (honorific)
移行	いこう	switching over to; migration; transition
支援	しえん	support; backing
抱える	かかえる	to hold or carry under or in the arms; to have (esp. problems, debts, etc.)
因って	よって	therefore; consequently; accordingly; because of
異なる	ことなる	to differ; to vary; to disagree
安全	あんぜん	safety; security
保障	ほしょう	guarantee; security
関連	かんれん	connection; relation
法案	ほうあん	bill (law)
安全保障	あんぜんほしょう	security guarantee (e.g. military security, network security, etc.)
安保	あんぽ	US-Japan Security Treaty; safety; security
議論	ぎろん	argument; discussion
副	とりわけ	especially; above all; inter alia; among others
集団	しゅうだん	group; mass
自衛	じえい	self-defense
集団的自衛権	しゅうだんてきじえいけん	right to collective defense; right to collective defence
関心事	かんしんじ	matter of concern and interest
気にする	きにする	worry; be concerned; care about
訳	わけ	reason; cause
自信	じしん	self-confidence
無し	なし	without
拝啓	はいけい	Dear (opening phrase of a letter)
敬具	けいぐ	Yours sincerely (closing of a letter)
結ぶ	むすぶ	to tie; to join
畏まる	かしこまる	to obey respectfully; to humble oneself
以外	いがい	with the exception of
表記	ひょうき	writing (something); giving an address; declaration; inscribing on the face of
組	くみ	set (of items); group (of people)
立てる	たてる	stand; set up; establish
組み立てる	くみたてる	build; set up; construct
準備	じゅんび	preparation; setup; arrangements
録画	ろくが	videotaping
片付ける	かたづける	to put in order; to tidy up; to dispose of; to do away with
騒ぐ	さわぐ	to make a racket; to mess around; to make a fuss
済む	すむ	to finish; to end; to be completed
構う	かまう	to mind; to care about; to be concerned about
長旅	ながたび	long trip
首都	しゅと	capital
遅刻	ちこく	tardiness; lateness
寝坊	ねぼう	late riser; oversleeping
どうせ	どうせ	anyway; at all; no matter what
飲食物	いんしょくぶつ	food and drink
祈る	いのる	pray; wish for
夢	ゆめ	dream
彼岸	ひがん	the equinoctial week
墓地	ぼち	graveyard; cemetery
蝋燭	ろうそく	candle
鶴	ツル	crane; stork
含める	ふくめる	to include; to put in
表紙	ひょうし	cover; binding
最も	もっとも	the most; extremely
機会	きかい	opportunity; occasion
気になる	きになる	to be concerned about; to worry about
気掛かり	きがかり	anxiety; concern; worry
完了	かんりょう	completion
日記	にっき	diary
流行る	はやる	be in fashion; be popular
選手	せんしゅ	player (in game); team member
どんどん	どんどん	knock; bang; steadily; rapidly
曖昧	あいまい	ambiguous; vague
相変わらず	あいかわらず	as usual; as before; the same
饅頭	まんじゅう	steamed yeast bun with filling
同意	どうい	consent; approval
番組	ばんぐみ	program
妄想	もうそう, ぼうそう	wild idea; delusion
編	へん	compilation (of a text); editing; volume (of a text); completed literary work
放送	ほうそう	broadcasting
放送する	ほうそうする	to broadcast
ご覧ください	ごらんください	please look at it
買い替える	かいかえる	to buy a replacement; to replace by buying something new
仕様	しよう	way; method; means; resource; remedy; (technical) specification
撮影	さつえい	photography
超	ちょう	super-; ultra-; hyper-; very; really; over; more than
趣旨	しゅし	object; intent; aim; meaning; point (e.g. of a statement)
西部	せいぶ	the west; western part; the West
伝統	でんとう	tradition; convention
伝統的	でんとうてき	traditional
として	として	as (i.e. in the role of); for (i.e. from the viewpoint of); trying to...
預ける	あずける	to give into custody; to leave (a child) in the care of; to entrust; to deposit
大好物	だいこうぶつ	(one's) favourite food; (one's) favorite food
偶然	ぐうぜん	chance; accident
意識する	いしきする	to be aware of
目撃	もくげき	to observe; to witness; eye-witness
現象	げんしょう	phenomenon
字幕	じまく	subtitle (movie)
内容	ないよう	contents
深い	ふかい	deep; thick; profound; intimate
興味深い	きょうみぶかい	very interesting
返事する	へんじする	to reply; respond
括る	くくる	to tie up; to tie together; to bundle; to fasten; to hang (oneself)
弧	こ	arc
括弧	かっこ	parentheses; brackets
位	い	rank
位	くらい	rank; dignity
置く	おく	put; leave
位置	いち	position; place
移る	うつる	to move; to shift
移動する	いどうする	to move, to remove
進める	すすめる	advance; promote
関心	かんしん	concern; interest
向く	むく	to face; turn toward; be suited to; fit for
手練	しゅれん, てだれ	skill; dexterity; master hand
奇術	きじゅつ	magic
割ける	さける	to be separated; to be divided
以来	いらい	since
既に	すでに	already; previously
終える	おえる	to end; to finish
元	もと	origin; source
不自然	ふしぜん	unnatural; artificial
区切る	くぎる	punctuate; divide
対	つい	pair
対	たい	opposite; opposition; to ("we won the game five to three"); equal terms; against ...
象	しょう	phenomenon
象	ぞう	elephant
対象	たいしょう	target; object
特別	とくべつ	special; extraordinary
権	けん	authority; right (to do something)
権利	けんり	right; privilege
権力	けんりょく	power; authority
特権	とっけん	privilege; special right
目覚める	めざめる	to wake up
目覚まし	めざまし	waking up
目覚まし時計	めざましどけい	alarm clock
席	せき	seat; position
工場	こうじょう	factory; plant
文字	もじ	character; letter
過激	かげき	extreme; radical
横浜	よこはま	Yokohama (place name)
越す	こす	to go over; to surmount
引っ越す	ひっこす	to move; to change quarters
間に合う	まにあう	to be in time for; to serve the purpose
締め切り	しめきり	cut-off; deadline; No Entrance
長い間	ながいあいだ	long interval
差し上げる	さしあげる	give (humble)
古文	こぶん, こもん	ancient writing; classical literature
市場	しじょう	(the) market (as a concept)
慣れる	なれる	to get used to; to grow accustomed to; to become familiar with;<br/>to become skilled in
少しずつ	すこしずつ	little by little
漸く	ようやく	finally; at last; barely; gradually
結露	けつろ	dew; condensation
曇る	くもる	become cloudy
入場料	にゅうじょうりょう	entrance fee; admission fee; gate receipts
無料	むりょう	no charge; free
関する	かんする	to concern; to relate to
に関して	にかんして	related to; in relation to
巷	ちまた	the public; street; district; quarters; location (of a battle, etc.)
岐	ちまた	the public; street; district; quarters; location (of a battle, etc.)
腐る	くさる	rot; corrode
溢れる	あふれる	overflow; flood over
非常	ひじょう	emergency; extraordinary; unusual
中心	ちゅうしん	center; middle; core
中心地	ちゅうしんち	center; centre; metropolis
華やか	はなやか	gorgeous; colorful
若者	わかもの	young person; youth
人気	にんき	popularity; temperament of the people; business conditions
辺り	あたり	vicinity; around
因る	よる	be caused by
依る	よる	to be due to; to be caused by; to depend on; to turn on; to be based on
寛大	かんだい	tolerance; liberality; leniency
寛大さ	かんだいさ	generosity
友人	ゆうじん	friend
付け込む	つけこむ	to take advantage of; to impose on; to make an entry
未来	みらい	future
助詞	じょし	particle; postposition
お台場	おだいば	Odaiba
信じる	しんじる	believe; trust; have faith in
帝国	ていこく	empire; imperial
時代	じだい	age; era; antiquity
王	おう	king
冠	かんむり	cap; crown
革命	かくめい	revolution
弾丸	だんがん	bullet; shot; shell
命中	めいちゅう	a hit; hitting something that was aimed at
講演	こうえん	lecture
宣伝	せんでん	publicity; advertisement; propaganda
糞	くそ, ふん	bullshit; shit; damn; feces; excrement; damned
開発	かいはつ	development
開発者	かいはつしゃ	developer
順序	じゅんじょ	order; sequence
段階	だんかい	gradation; stage; steps; order
計画	けいかく	plan; project; scheme; program
風景	ふうけい	scenery; landscape
穏やか	おだやか	calm; gentle; quiet; mild
消臭剤	しょうしゅうざい	deodorizer
年上	としうえ	older; senior
昼寝	ひるね	siesta; nap
付き合う	つきあう	associate with; keep company with; come along; go out (date)
見つかる	みつかる	to be found; to be caught
お蔭	おかげ	(your) backing; assistance; thanks or owing to
只	ただ	ordinary; usual; free of charge; as is; safe; only; merely; simply; but; however
周り	まわり	circumference; perimeter; surroundings
不便	ふべん	inconvenient
再生	さいせい	playback
見出す	みいだす, みだす	to find out; to discover; to notice; to select
聴解	ちょうかい	listening comprehension
読解	どっかい	reading comprehension
受験	じゅけん	take an examination
受かる	うかる	pass (examination)
専攻	せんこう	major; specialization
競争	きょうそう	competition
講演会	こうえんかい	lecture
蒸れる	むれる	to be stuffy; to moulder; to molder
群れる	むれる	to crowd; to flock; to swarm
蒸す	むす	to steam
原文	げんぶん	the text; original
半分	はんぶん	half
思いっきり	おもいっきり	with all one's strength; with all one's heart; resignation; resolution
検定	けんてい	giving official approval; inspecting
羨ましい	うらやましい	envious; envy
類い	たぐい	a kind
すら	すら	even; if only; if just; as long as; the only thing needed
通じる	つうじる	pass; communicate with
合否	ごうひ	success or failure; result
受け止める	うけとめる	catch; receive
合点	がてん, がってん	consent; assent; understanding; agreement; comprehension; grasp
過去	かこ	the past
遡る	さかのぼる	go back; go upstream; make retroactive
参考	さんこう	reference; consultation
一部	いちぶ	a part
抜き出す	ぬきだす	to start to pull out
表	おもて	surface; face (the visible side of an object); front (of a building)
表す	あらわす	to express; to represent; to show
馴染み	なじみ	intimacy; friendship; familiarity
遭遇	そうぐう	encounter
まだまだ	まだまだ	still some way to go before goal; still more to come
諸国	しょこく	various countries; various regions; various provinces
恐ろしい	おそろしい	terrible; awful
生命	せいめい	life; existence
危険	きけん	danger; dangerous
向かう	むかう	face; confront; head toward
他国	たこく	foreign country; another province
通過	つうか	passing; passage
入国	にゅうこく	entry into a country; immigration
許す	ゆるす	to permit; to allow; to forgive
法律	ほうりつ	law
行動	こうどう	action; conduct; behaviour
変わる	かわる	to change; be transformed
変る	かわる	to change; to be transformed; to vary; to be revised; to be replaced
鈍い	にぶい	dull (blade); slow; dumb
字	あざ	section of village
世界中	せかいじゅう	around or throughout the world
本格	ほんかく	original method or procedure; serious; orthodox; classical; genuine
由来	ゆらい	origin; source; history; derivation
綴り	つづり	spelling; orthography; patching; binding
前回	ぜんかい	last time (previous time)
疑問	ぎもん	question; doubt
拝見	はいけん	seeing; look at (humble)
辿る	たどる	follow; trace; pursue
勤務	きんむ	duty; service
今後	こんご	after this; in the future
頻繁	ひんぱん	frequent; incessant
聞き手	ききて	listener; audience
打ち明ける	うちあける	confide in; reveal
繋がり	つながり	connection; relation
纏める	まとめる	gather together; put in order
それはさておき	それはさておき	apart from that; to return to the topic; enough of that
挟む	はさむ	to pinch; to hold between; to insert
同様	どうよう	similar
全体	ぜんたい	whole; entirety
音声	おんせい, おんじょう	voice; (the concept of) sound
帰宅	きたく	return home
気付き	きづき	awareness
発表	はっぴょう	announcement; publication
明らか	あきらか	clear; obvious
延々	えんえん	forever; endlessly; on and on; meandering; wandering; winding; sinuous
保存	ほぞん	preservation; conservation
師走	しわす	twelfth month of the lunar calender
代名詞	だいめいし	pronoun
夜勤	やきん	night shift
心境	しんきょう	mental state
生きる	いきる	to live
生きていかれない	いきていかれない	can't survive (without ...)
～何て	～なんて	such; like (follows a noun, sarcastic/negative nuance)
見付ける	みつける	discover; locate
見付かる	みつかる	to be found; to be discovered
悟る	さとる	perceive; realize; be enlightened
曲名	きょくめい	song title; song titles
歌手	かしゅ	singer
作詞	さくし	(writing) song lyrics
作曲	さっきょく	composition (of a song)
本年	ほんねん	this year
新年	しんねん	New Year
半年	はんとし	half a year
年内	ねんない	by the end of the year
難民	なんみん	refugees
普段	ふだん	usual; ordinary
語学	ごがく	language study
休憩	きゅうけい	rest; break; recess; intermission; repose
数日	すうじつ	few days
以前	いぜん	before; ago
在宅	ざいたく	being at home
転職	てんしょく	change of occupation
機	はた	a loom
形	かたち	shape; form
性能	せいのう	performance; capacity
近々	ちかぢか	soon; nearness; before long
開催	かいさい	holding (of an event); opening
都市	とし	city; urban community
立候補	りっこうほ	candidacy
騒ぎ出す	さわぎだす	to start making a noise, to start making an uproar
知識	ちしき	knowledge
中々	なかなか	(not) easily/readily; very
参る	まいる	go; come; be defeated; collapse; be annoyed; visit (shrine; grave)
海岸	かいがん	seashore; coast
写る	うつる	to be photographed; to be projected
載る	のる	appear in print
予め	あらかじめ	in advance
下調べ	したしらべ	preliminary investigation; preparation
姿	すがた	figure; appearance
見かける	みかける	to (happen to) see; to notice; to catch sight of
乗せる	のせる	to place; to put on; to give someone a ride
訳す	やくす	to translate; to interpret
不思議	ふしぎ	mystery; wonder; strange
感覚	かんかく	sense; sensation
性	せい	sex; nature
胃腸	いちょう	stomach and intestines
炎	ほのお	flame; blaze
当たる	あたる	to hit; to strike
熱意	ねつい	zeal; enthusiasm
下がる	さがる	come down; hang down; fall
比べる	くらべる	compare; contrast
英文	えいぶん	English; English writing
自問	じもん	asking oneself
進歩	しんぽ	progress; advancement
強化	きょうか	strengthening
国会	こっかい	National Diet; parliament; congress
議事堂	ぎじどう	Diet building
古城	こじょう	old castle; old fortress
旧跡	ふるあと, きゅうせき	historic spot; historic remains; ruins
河川	かせん	rivers
地元	じもと	home area; home town; local
河口	かこう	river mouth; estuary
三脚	さんきゃく	tripod; three legs
積む	つむ	pile up; accumulate
走り回る	はしりまわる	to run around
挿し絵	さしえ	(book) illustration
流れる	ながれる	to flow; to pass; to drift away
沿い	ぞい	along
異国	いこく	foreign country
情緒	じょうちょ, じょうしょ	emotion; feeling; spirit
たっぷり	たっぷり	fully; amply
純粋	じゅんすい	pure; unmixed; true; genuine
世紀	せいき	century
番外	ばんがい	extra
人妻	ひとづま	married woman; another's wife
欧州	おうしゅう	Europe
魅了	みりょう	fascination
奥様	おくさま	married woman; someone's wife
国民	こくみん	the people; nation
長々	ながなが	long; drawn-out; very long
主人公	しゅじんこう	main character; protagonist; head of household
独身	どくしん	single; unmarried
毒	どく	poison
毒性	どくせい	toxicity; toxic; virulence; virulent
当てはまる	あてはまる	to apply (a rule); to be applicable; to come under (a category); to fulfill
手にする	てにする	to hold (in one's hand); to take (into one's hand); to own; to obtain
うんざり	うんざり	tedious; boring; being fed up with
意志	いし	will; volition
堕落	だらく	depravity; corruption; degradation
自堕落	じだらく	depravity; self-indulgence
人間	にんげん	human being; person; man; mankind; humankind; personality
褒める	ほめる	to praise; to commend
主語	しゅご	subject (grammar)
目的語	もくてきご	object
一般	いっぱん	general; common
一般論	いっぱんろん	prevailing view; common opinion; general consideration
省略	しょうりゃく	omission; abbreviation
歯切れ	はぎれ	the feel when biting; manner of enunciation
嫌悪	けんお	disgust; hate; repugnance
自己嫌悪	じこけんお	self-hatred; self-abhorrence; self-loathing
陥る	おちいる	to fall; to trap; to cave in; to collapse
固い	かたい	stiff; tight; hard; firm
硬い	かたい	hard; solid; stiff; strong; safe; stubborn
飽きる	あきる	to be fed up
適切	てきせつ	appropriate; adequate
直感	ちょっかん	intuition; instinct; insight; hunch
最低	さいてい	least; lowest; disgusting; yuck!
文脈	ぶんみゃく	context
上記	じょうき	above-mentioned; above-named; above
略して	りゃくして	for short
早春	そうしゅん	early spring
反発	はんぱつ	opposition; rebellion; backlash; rebound
別れる	わかれる	to be divided; to separate;
彼氏	かれし	boyfriend
洋介	ようすけ	Yousuke (male name)
智子	ともこ	Tomoko (name)
求人	きゅうじん	recruiting
面接	めんせつ	interview
筆記	ひっき	(taking) notes; copying
審査	しんさ	judging; inspection; examination; investigation
研修	けんしゅう	training
経る	へる	to pass; to elapse
模擬	もぎ	imitation; sham; mock; simulation
求人広告	きゅうじんこうこく	help-wanted advertisement
筆記試験	ひっきしけん	written examination
人類	じんるい	mankind; humanity
規制	きせい	regulation; control
と共に	とともに	together with
新着	しんちゃく	new arrivals; new acquisitions
かなり	かなり	fairly, rather
引き換え	ひきかえ	exchange; conversion; on the contrary; on the other hand
引き替え	ひきかえ	exchange; conversion; on the contrary; on the other hand
引き返す	ひきかえす	turn back; retrace one's steps
避ける	さける	avoid; evade
無理矢理	むりやり	forcibly; against one's will
徹夜	てつや	staying up all night
成るべく	なるべく	as ... as possible; if possible
落書き	らくがき	graffiti
壊れる	こわれる	to be broken; to break
頂戴	ちょうだい	receiving; reception; getting; being given; getting<br/>eating; drinking; having<br/>please; please do for me (feminine, after -te form)
目次	もくじ	table of contents
概要	がいよう	outline; summary; abridgment; synopsis
版	はん	edition; version
集	しゅう	collection; compilation
作成	さくせい	framing; drawing up; creating
初旬	しょじゅん	first 10 days of the month
認定	にんてい	authorization; authorisation; acknowledgment; acknowledgement; certification
目安	めやす	criterion; standard; reference; approximation
級	きゅう	grade; class
旧	きゅう	old; former, ex-
日常的	にちじょうてき	day-to-day; common; ordinary
科目	かもく	subject; curriculum; course
語彙	ごい	vocabulary; lexicon; lexis; terminology
判定	はんてい	judgement; judgment; decision; award; verdict; determination
お知らせ	おしらせ	notice; notification
案内	あんない	information; leading; to guide
日時	にちじ	date; time
例外	れいがい	exception
場面	ばめん	scene; situation
程度	ていど	degree; extent
独立	どくりつ	independence; self-reliance
行政	ぎょうせい	administration
法人	ほうじん	corporate body; corporation; (legal) person; (juridical) person
祭	まつり	festival; feast
団	だん	body; group; party; company; troupe
教育	きょういく	education
独立行政法人	どくりつぎょうせいほうじん	independent administrative corporation (institution, agency)
基金	ききん	fund; foundation
交流	こうりゅう	(cultural) exchange; interchange; interaction; (inter-) mingling; (social, etc.)
国際交流基金	こくさいこうりゅうききん	Japan Foundation
協会	きょうかい	association
米印	こめじるし	rice symbol; note (supplementary information) symbol
天文学	てんもんがく	astronomy
宇宙開発	うちゅうかいはつ	space development
歓迎	かんげい	welcome; reception
大歓迎	だいかんげい	warm welcome
接尾辞	せつびじ	suffix
硫黄	いおう	sulfur (S); sulphur
飼う	かう	to keep (a pet or other animal); to raise; to have; to own; to feed
一寸	ちょっと, ちょと	just a minute; short time; just a little; somewhat; easily; readily; rather
程	ほど	extent; limit
残響	ざんきょう	reverberation; echo
残業	ざんぎょう	overtime
吹き替え	ふきかえ	dubbing; stand-in; dummy
分割	ぶんかつ	partition, division, separation, segmenting, splitting
奴	やつ	fellow; guy; chap; thing; object; (derogatory or familiar) he; she; him; her
さっさと	さっさと	quickly
込む	こむ	to be crowded; to be congested
一体	いったい	what on earth; what the…
俺	おれ	I; me (rough or arrogant-sounding first-person pronoun)
怠ける	なまける	to be idle; to slacken; to neglect (e.g. ones work)
空く	あく	to become available or vacant
空く	すく	to be empty
長時間	ちょうじかん	long period of time; long playing
何回	なんかい	how many times?
感染	かんせん	infection; contagion
感染する	かんせんする	to infect
休日	きゅうじつ	holiday; day off
遣り取り	やりとり	giving and taking; exchange (of letters); arguing back and forth
他人行儀	たにんぎょうぎ	reserved manners
祖父母	そふぼ	grandparents
目上	めうえ	one's superiors; one's elders
物理	ぶつり	physics; natural law
精神	せいしん	mind; spirit
距離	きょり	distance; interval
暫く	しばらく	awhile; long time; for the time being
親しい	したしい	intimate; close (e.g. friend)
追伸	ついしん	P.S.
間柄	あいだがら	relation(ship)
語尾	ごび	(inflected) end of a word
親しみ	したしみ	intimacy; familiarity
ユーザ名	ユーザめい	username
変更	へんこう	alteration; change
変更する	へんこうする	to change
気楽	きらく	at ease; comfortable
気遣い	きづかい	worry
社員	しゃいん	staff member; employee
山道	さんどう, やまみち, せんどう	mountain road; mountain trail
日食	にっしょく	solar eclipse
越える	こえる	to go over; to go across; to go beyond; to exceed
超える	こえる	to exceed; surpass
不可能	ふかのう	impossible
あらゆる	あらゆる	all; every (possible)
有らゆる	あらゆる	all; every
含む	ふくむ	to contain; to comprise; to include
領収証	りょうしゅうしょう	receipt
限界	げんかい	boundary; limit
勝つ	かつ	to win
個人	こじん	individual
彼奴	あいつ, きゃつ, かやつ	he; she; that guy
小説	しょうせつ	novel; story
人工知能	じんこうちのう	AI; artificial intelligence
研究	けんきゅう	research; study
物語	ものがたり	tale; story
文学賞	ぶんがくしょう	literary prize
人工	じんこう	artificial; man-made
爆発	ばくはつ	explosion; eruption
国際空港	こくさいくうこう	international airport
亡い	ない	dead
亡くなる	なくなる	to pass away; to die
爆弾	ばくだん	bomb
関係	かんけい	relation; connection
原発	げんぱつ	nuclear power plant; nuclear power supply
原子力	げんしりょく	atomic energy; nuclear power
発電所	はつでんしょ	power plant; generating station
原子力発電所	げんしりょくはつでんしょ	nuclear power plant; nuclear power station
放射	ほうしゃ	radiation; emission
放射性	ほうしゃせい	radioactive
物質	ぶっしつ	matter; substance
放射性物質	ほうしゃせいぶっしつ	radioactive material
放射線	ほうしゃせん	radiation
金属	きんぞく	metal
幅	はば	width; breadth
資料	しりょう	materials; data
家庭教師	かていきょうし	tutor; coach
惑星	わくせい	planet
岩石	がんせき	rock
ガス惑星	ガスわくせい	gas planet
岩石惑星	がんせきわくせい	rocky planet
状	じょう	shape; state; letter; correspondence
ガス状惑星	ガスじょうわくせい	gas giant (e.g. Jupiter, Saturn); gas planet
知り合う	しりあう	get acquainted with
繰り返し	くりかえし	repetition; reiteration; iteration; cycle; repeatedly
寝れる	ねれる	to be able to sleep
切っ掛け	きっかけ	chance; cue; impetus
切っ掛けに	きっかけに	with ... as a start; taking advantage of
曲目	きょくもく	program; programme; musical selection; tunes
気が進まない	きがすすまない	reluctant to; not inclined to; disinclined; unwilling
ぎりぎり	ぎりぎり	just in time; barely
要塞	ようさい	fortress; stronghold
一晩中	ひとばんじゅう	all night long; all through the night
綴り方	つづりかた	(way of) literary composition; (way of) spelling; school composition
魂	たましい	a soul; a spirit
贅沢	ぜいたく	luxury; extravagance
唯一	ゆいいつ	only; sole; unique
抱っこ	だっこ	(child's) hug; carrying a baby in one's arms; carrying a pet in one's arms
抱っこする	だっこする	pick (the baby) up
紐	ひも	laces; string; rope
辞典	じてん	dictionary
辞める	やめる	to resign; to retire
印象	いんしょう	impression
総まとめ	そうまとめ	Roundup
纏め	まとめ	summary
総人口	そうじんこう	total population
割り込む	わりこむ	cut in
邪魔	じゃま	obstacle; interference; in the way
邪魔する	じゃまする	to obstruct
表面	ひょうめん	surface; appearance
着せ替える	きせかえる	to change clothes on a doll
着せ替え人形	きせかえにんぎょう	dress-up doll
遺産	いさん	inheritance; legacy; estate
世界遺産	せかいいさん	world heritage
文化的	ぶんかてき	cultural
届ける	とどける	to deliver; to give notice
解凍	かいとう	thaw; defrosting; decompression (e.g. of a file); unpacking; extracting
文頭	ぶんとう	start of a sentence, phrase, etc.
冗長	じょうちょう	tedious; verbose; prolix; redundancy
伝える	つたえる	to convey; to report; to transmit; to communicate; to tell
省く	はぶく	to omit; to dispense with
対応	たいおう	interaction; correspondence; coping with; dealing with; support; response; reception; equivalence;<br/>software support; ability of a computer system to run specific software; compatibility
直接	ちょくせつ	direct; immediate; personal; firsthand; directly
迷惑	めいわく	trouble; bother; annoyance
映じる	えいじる	to be reflected (in); to be mirrored (in); to impress (a person)
反映	はんえい	reflection
見合う	みあう	to exchange glances; to correspond; to counterbalance
弾く	ひく	play (guitar, piano)
実際に	じっさいに	really; indeed; truly
逆さ	さかさ	reverse; inversion
映像	えいぞう	reflection; image; picture (e.g. on a television); shot; clip
汚れる	よごれる	to become dirty
汚す	よごす	pollute; make dirty; to disgrace
駄洒落	だじゃれ	pun
鼠取り	ねずみとり	mousetrap; rattrap; speed trap; rat poison
惜しい	おしい	disappointing; deserving better; almost but not quite; precious
愛	あい	love
平和	へいわ	peace; harmony
齎す	もたらす	bring about; lead to
そっくり	そっくり	identical; look alike
受け取る	うけとる	to receive; to accept; to interpret; to understand
輝く	かがやく	to shine brilliantly; to glitter
光る	ひかる	to shine; emit light
お洒落	おしゃれ	dressing up smartly; trendy
変身	へんしん	change oneself
任せる	まかせる	entrust to; leave it to
透明	とうめい	transparent
色づく	いろづく	to change color; to change colour
伝説	でんせつ	legend; folk tale
注入	ちゅうにゅう	pouring; injection
七色	なないろ, しちしょく	the seven prismatic colors (colours)
きらきら	きらきら	shining; sparkling
哀しみ	かなしみ	sadness; sorrow; grief
証拠	しょうこ	proof; evidence
独り	ひとり	one person; alone; unmarried
最強	さいきょう	strongest
恋	こい	(romantic) love; tender passion
起き上がる	おきあがる	get up; rise
画質	がしつ	image quality (film, video, etc.)
向け	むけ	intended for ... ; oriented towards ... ; aimed at ...
上旬	じょうじゅん	beginning of the month
中旬	ちゅうじゅん	middle ten days of a month
下旬	げじゅん	month (last third of)
第	だい	ordinal
第三者	だいさんしゃ	third person, outsider, disinterested person
祝日	しゅくじつ	national holiday
ただし	ただし	but; however
尚	なお	still; in addition
女子	じょし	woman; girl
男子	だんし	boy; young man
中央	ちゅうおう	center
中央図書館	ちゅうおうとしょかん	central library
問い	とい	question; inquiry
開館	かいかん	opening a hall for that day's business (museum, library, such like buildings)
開館時間	かいかんじかん	hours of being open
休館日	きゅうかんび	day(s) a hall is closed
児童室	じどうしつ	children's room
使用	しよう	usage; use; application; employment; utilization; utilisation
重なる	かさなる	be piled up; come one after another
工事	こうじ	construction
電気工事	でんきこうじ	electrical work
臨時	りんじ	temporary; provisional
利用	りよう	utilization; usage
翌日	よくじつ	the following day
閉館	へいかん	closing of a building
独学	どくがく	self-education; self-instruction; self-study
抹茶	まっちゃ	powdered green tea for ceremonies
匂い	におい	smell; odor
匂う	におう	smell (pleasant)
主義	しゅぎ	principle; -ism
躾	しつけ	home discipline; training; upbringing; breeding
仕付け	しつけ	rice planting; tacking; basting; discipline
仕付ける	しつける	to be used to a job; to begin to do; to baste; to tack; to plant
方向	ほうこう	direction; bearing; way; course (e.g. of action)
四つ角	よつかど	street corner; intersection
斜め	ななめ	diagonal; slant
手前	てまえ	in front; this side
有料駐車場	ゆうりょうちゅうしゃじょう	toll parking lot; toll car park
突き当たり	つきあたり	end (e.g. of street)
前方	ぜんぽう	front
後方	こうほう	back; rear
右折する	うせつする	to make a right turn
左折する	させつする	make a left turn; turn (to the) left
徒歩	とほ	walking; going on foot
面する	めんする	to face; look on to
一方通行	いっぽうつうこう	one-way traffic
会話文	かいわぶん	conversational sentence; dialog
会場	かいじょう	assembly hall; meeting place
説明会	せつめいかい	information session
案内図	あんないず	guide map
地下	ちか	basement; underground
軒	けん	counter for houses
本音	ほんね	real intention; motive
建て前	たてまえ	a front; polite face
花粉	かふん	pollen
症	しょう	illness
苦しむ	くるしむ	to suffer; to be troubled
鼻水	はなみず	nasal mucus; dripping nose
嚏	くしゃみ	sneeze
日数	にっすう	number of days
辛い	づらい	hard to; difficult to
幸い	さいわい	happiness; good fortune
花粉症	かふんしょう	pollen allergy
酷い	ひどい	cruel; severe
頭痛	ずつう	headache
どうぞお大事に。	どうぞおだいじに。	Please take care of yourself.
時差ぼけ	じさぼけ	jet-lag
との事	とのこと	I'm told; indicates someone has heard the information from someone
制汗剤	せいかんざい	deodorant
解像度	かいぞうど	resolution (e.g. display, dpi); granularity (e.g. timer)
申請	しんせい	application; petition
承認	しょうにん	approval; recognition
打者	だしゃ	batter (baseball)
担ぐ	かつぐ	to carry on one's shoulder; to deceive
担当する	たんとうする	be responsible for
接する	せっする	come in contact; adjoin
接続	せつぞく	connection; joining
支える	ささえる	to support; to sustain
技	わざ,ぎ	technique; skill; art; feat
特技	とくぎ	special talent/ability; specialty
技術力	ぎじゅつりょく	technological strength
育てる	そだてる	to bring up; to raise; to breed; to train
育つ	そだつ	be brought up; grow
売り切れ	うりきれ	sellout; sold out
大騒ぎ	おおさわぎ	making great noise (yelling, cheering and laughing)
投手	とうしゅ	(baseball) pitcher
探る	さぐる	feel about (for something); investigate
探検	たんけん	exploration; expedition
復習	ふくしゅう	review; revision
値上がり	ねあがり	price rise
授業料	じゅぎょうりょう	tuition fee
望む	のぞむ	to desire; to hope
望み	のぞみ	desire; hope
修正	しゅうせい	correction; revision
新製品	しんせいひん	new product
発売	はつばい	put on the market
並べ替える	ならべかえる	to rearrange
曲	きょく	song; melody; tune; composition; piece of music
蓋	ふた	lid; cover; cap
動作	どうさ	movements; actions
噛む	かむ	to bite; to chew
吠える	ほえる	to bark; to bay
人口	じんこう	population
世話	せわ	looking after; help; aid; assistance
金魚	きんぎょ	goldfish
図	ず	figure; map
輸出	ゆしゅつ	export
安売り	やすうり	bargain sale
努力	どりょく	endeavor; effort
水分	すいぶん	moisture
愛情	あいじょう	love; affection
叱る	しかる	to scold; to tell off; to reprimand
楽ちん	らくちん	pleasant; easy-going; easy life
健康	けんこう	health
保証	ほしょう	guarantee; security; assurance; pledge; warranty
解決	かいけつ	solution; settlement; resolution
渋滞	じゅうたい	congestion (e.g. traffic); delay; stagnation; traffic jam
首都圏	しゅとけん	the capital city (often Tokyo) area (typically within 50 km of city's centre) (center)
状況	じょうきょう	state of affairs; circumstances; situation
現在	げんざい	the present; present time
過ち	あやまち	fault; mistake
農業	のうぎょう	agriculture
論文	ろんぶん	thesis; paper
速報	そくほう	news flash; prompt report; bulletin; quick announcement
震度	しんど	seismic intensity
克服	こくふく	subjugation; conquest; victory
屋根	やね	roof
話し合う	はなしあう	to discuss; to talk over
話し合い	はなしあい	talk; discussion
被害	ひがい	damage; harm
市民	しみん	citizen; townspeople
被害者	ひがいしゃ	victim; injured party; sufferer
一言	ひとこと	a word; few words; brief comment
飛ばす	とばす	to fly; to shoot; to skip over; to omit
広がる	ひろがる	to spread (out); to extend; to stretch; to reach to; to get around; to fill (e.g. a space)
すっかり	すっかり	all; completely
ぐっすり	ぐっすり	sound asleep; fast asleep
有料	ゆうりょう	fee-charging; pay
次々	つぎつぎ	one after another; one by one
今頃	いまごろ	about this time
可愛がる	かわいがる	love; cherish
短気	たんき	short temper; quick-temper
に於いて	において	in; on; at (place); as for; regarding
縛る	しばる	to tie; to bind
自由	じゆう	freedom; free
玉ねぎ	たまねぎ	onion
防ぐ	ふせぐ	to prevent; to defend
大量	たいりょう	large quantity; great volume
満	まん	full (years, etc.)
不満	ふまん	dissatisfaction; discontent
申込書	もうしこみしょ	application form
納車	のうしゃ	delivery of a vehicle (to its new owner)
疎か	おろそか, おろか	neglect; negligence; carelessness; not to mention; needless to say
部品	ぶひん	parts; accessories
役に立たない	やくにたたない	of no avail; useless
傷	きず	wound; scar
拭く	ふく	wipe; dry
埃	ほこり	dust
修理	しゅうり	repairing; mending; servicing
たった	たった	only; merely
汗	あせ	sweat
情け	なさけ	sympathy; compassion
情けない	なさけない	pitiful; shameful
怪しい	あやしい	suspicious; dubious
栄養	えいよう	nutrition; nourishment
自慢	じまん	pride; boast
中断	ちゅうだん	interruption; discontinuance
同梱	どうこん	including something in a package
嵌まる	はまる	to get into; to go into; to fit; to be fit for; to suit; to fall into
聴く	きく	to hear; to listen (e.g. to music); to ask; to enquire; to query
支持	しじ	support; maintenance
戦場	せんじょう	battlefield; front
劇場版	げきじょうばん	movie version (based on TV series, anime, etc.); the movie
本編	ほんぺん	original story; original version; this volume
観る	みる	see/watch (a play, movie, sports game, etc)
泣ける	なける	to shed tears; to be moved to tears
お気に入り	おきにいり	favorite; favourite; pet
手がける	てがける	to make; to do; to produce; to work on
盛り上がる	もりあがる	become lively; get fired up
期待	きたい	expectation; anticipation
徐々	じょじょ	gradually; steadily; quietly; slowly; soon
鳥肌	とりはだ	gooseflesh; goose pimples; goose bumps
鳥肌が立つ	とりはだがたつ	to get goosebumps
総毛立つ	そうけだつ	to relate a hair-raising account or experience
作曲家	さっきょくか	composer
多数	たすう	large number; multitude
心情	しんじょう	sentiment; emotions; one's feelings; one's heart
心情的	しんじょうてき	sentimental; on an emotional level; in one's heart
現実	げんじつ	actuality; reality
現実的	げんじつてき	realistic; pragmatic
こっそり	こっそり	stealthily; secretly
ご無沙汰	ごぶさた	not writing or contacting for a while; long silence
界隈	かいわい	neighborhood; neighbourhood
割と	わりと	relatively; comparatively
元い	もとい	(in calisthenics) return to your original position!
呑む	のむ	to drink; to gulp; to swallow; to smoke (tobacco); to engulf; to overwhelm
等距離	とうきょり	equidistant
落ち着く	おちつく	calm down; settle in
肌	はだ	skin; surface
懐かしい	なつかしい	dear; missed; nostalgic
路地	ろじ	alley; alleyway; lane; teahouse garden
ごちゃごちゃ	ごちゃごちゃ	jumble; mix up; complaining about various things
当時	とうじ	at that time; in those days
都内	とない	in the metropolitan area of Tokyo
構える	かまえる	set up (shop)
職場	しょくば	place of work; office
出資	しゅっし	investment; contribution; financing
専門学校	せんもんがっこう	vocational/technical school
非常勤講師	ひじょうきんこうし	part-time lecturer; contract teacher
飾る	かざる	to decorate
派手	はで	showy; flashy
外れる	はずれる	be disconnected; get out of place; be off
幼少	ようしょう	infancy; childhood; tender age
連想	れんそう	association (of ideas); suggestion
いつの間にか	いつのまにか	before one becomes aware of; unnoticed
建設	けんせつ	construction; building
建設中	けんせつちゅう	under construction
溶け込む	とけこむ	melt into; become part of
浮き	うき	float (fishing); buoy
逞しい	たくましい	burly; strong; sturdy
管理	かんり	control; management (e.g. of a business)
早朝	そうちょう	early morning
巡り	めぐり	circumference; girth; tour; pilgrimage; circulation (e.g. of blood)
林道	りんどう	path through forest; woodland path
散策	さんさく	walking; strolling
大差	たいさ	great difference
絡める	からめる	to arrest; to entwine; to twine around; to mix together; to coordinate (with)
下流	かりゅう	lower classes; downstream
上流	じょうりゅう	upstream
県道	けんどう	prefectural road
抜ける	ぬける	to come out; to leave
クモの巣	クモのす	spiderweb
引っかかる	ひっかかる	to be caught in; to be stuck in; to be cheated
常に	つねに	always; constantly
脇	わき	armpit; the other way; another place; flank; supporting role
看板	かんばん	signboard; sign
曲がる	まがる	to bend; to turn; to curve
全線	ぜんせん	the whole line; all lines; the whole ship
全開	ぜんかい	opening fully; full throttle
ゆったり	ゆったり	comfortable
鳴き声	なきごえ	cry (esp. animal); roar
ぐるっと	ぐるっと	turning in a circle; going around; turning about; surrounding; encircling
素通り	すどおり	passing through without stopping; passing by
北上	ほくじょう	going north
南下	なんか	going south
大福	だいふく	great fortune; good luck; rice cake stuffed with bean jam
経つ	たつ	to pass; to elapse
舗装	ほそう	pavement; road surface
砂ぼこり	すなぼこり	cloud of dust (sand, etc.)
薄ら	うっすら, うすら	thinly; lightly; slightly; hazy; fuzzy; dim; faint; slight
足回り	あしまわり	chassis; undercarriage (of automobile or truck)
轍	わだち, てつ	rut; wheel track; furrow
擦る	こする	rub; strike
ヶ所	かしょ	passage; place; point; part
念の為	ねんのため	(just) making sure; just to be sure
歴代	れきだい	successive generations; successive emperors
愛車	あいしゃ	(one's) beloved car
実物	じつぶつ	real thing; actual object
やり直し	やりなおし	doing over; redoing
珍しい	めずらしい	unusual; rare
国道	こくどう	national highway
標識	ひょうしき	sign; mark; flag
汗だく	あせだく	dripping with sweat; bathed in perspiration
内輪ネタ	うちわネタ	private joke; inside joke
流石に	さすがに	as one would expect; still; all the same
範囲	はんい	range; scope
広範囲	こうはんい	extensive; vast range; wide scope
追跡	ついせき	pursuit; chase
向かって左	むかってひだり	on the left as one faces (it)
向かって右	むかってみぎ	on the right as one faces (it)
非常用	ひじょうよう	for emergency use
洪水	こうずい	flood; inundation
訪れる	おとずれる	to visit; to arrive, come or appear unexpectedly
洗車	せんしゃ	car wash
洗車場	せんしゃじょう	car wash
井戸水	いどみず	well water
こびり付く	こびりつく	to stick to; to cling to
戦利品	せんりひん	spoils of war; booty
坂	さか	slope; incline
路上	ろじょう	(on the) road; (on the) way
着地	ちゃくち	landing
拡大	かくだい	magnification; enlargement
手打ち	てうち	making noodles by hand; striking a deal; coming to an agreement; reconciliation
促す	うながす	urge; prompt; quicken
注意を促す	ちゅういをうながす	to call a person's attention (to)
音変化	おんぺんか	change in sound; shift in sound
辿り着く	たどりつく	to struggle on to; to arrive somewhere after a struggle; to grope along to
我が家	わがや	one's home
鍵盤楽器	けんばんがっき	keyboard (keyed) instrument
様式	ようしき	style, form, pattern
追記	ついき	PS; postscript
磁石	じしゃく	magnet; compass
月給	げっきゅう	monthly salary
髪の毛	かみのけ	hair
乾かす	かわかす	dry; dessicate (transitive)
乾く	かわく	dry; run dry
雨乞い	あまごい	praying for rain
人数	にんずう	number of people
体重	たいじゅう	body weight
増やす	ふやす	increase; add
減らす	へらす	to abate; to decrease; to diminish; to shorten
減る	へる	to decrease (in size or number); to diminish; to abate
他動詞	たどうし	transitive verb (direct obj.)
自動詞	じどうし	intransitive verb (no direct obj)
焼ける	やける	to be burned; be baked; be scorched
記憶	きおく	memory; recollection
絡む	からむ	to entangle; to entwine; to pick a quarrel; to find fault; to be involved with
絡み	からみ	linkage; entanglement; involvement; relationship
遠ざかる	とおざかる	to go far off
正直	しょうじき	honest; upright
何事	なにごと	what; something; everything; nothing (with neg. verb)
本動詞	ほんどうし	main verb
助動詞	じょどうし	auxiliary verb
予告編	よこくへん	(film, movie) preview
病人	びょうにん	sick person; patient
立ち上げる	たちあげる	to start (something); to boot (a computer)
立ち上がる	たちあがる	stand up; take action
殖やす	ふやす	increase; add to; augment
離す	はなす	to part; to divide; to separate; to release
離れる	はなれる	to be separated from; to leave
出産	しゅっさん	childbirth; (giving) birth; delivery; parturition; confinement<br/>production (of goods)
生物	せいぶつ	living thing; creature; biology
この世	このよ	this world; the present life
強調	きょうちょう	emphasis; stress
縞馬	しまうま	zebra
誕生	たんじょう	birth
抽象	ちゅうしょう	abstraction
傑作	けっさく	masterpiece; best work
利益	りえき	profit; benefit; advantage; interest (of the public, etc.)
誤解	ごかい	misunderstanding
発言	はつげん	utterance; speech
産む	うむ	to give birth to
生む	うむ	to give birth; to bear (child); to lay (eggs) <br/>to produce; to yield; to give rise to; to deliver
生まれる	うまれる	to be born
産まれる	うまれる	to be born
貴重	きちょう	precious; valuable
有意義	ゆういぎ	significant; useful; meaningful; worthwhile; valuable; of interest
韻文	いんぶん	verse; poetry
宅配	たくはい	home delivery
無用	むよう	useless; unnecessary
母音	ぼいん	vowel
子音	しいん	consonant
鍾乳洞	しょうにゅうどう	limestone cave (cavern, grotto)
菊	きく	chrysanthemum
低音	ていおん	low tone; bass; low voice
高音	こうおん, たかね	high-pitched tone; soprano
上司	じょうし	boss
休業	きゅうぎょう	suspension of business; closure
商品	しょうひん	commodity; goods; merchandise
溺れる	おぼれる	to drown; to be drowned
語源	ごげん	word root; word derivation; etymology
婉曲	えんきょく	euphemistic; circumlocution; roundabout; indirect
そびれる	そびれる	to miss a chance; to fail to do
ややこしい	ややこしい	puzzling; tangled; complicated; complex
禁断	きんだん	prohibition; interdiction
掘り下げる	ほりさげる	to dig down; to delve into; to get to the bottom of (a matter)
喉ちんこ	のどちんこ	uvula
口蓋垂	こうがいすい	uvula
奥	おく	inner part; the back; inner chamber
空気	くうき	air; atmosphere
呼気	こき	exhalation
塞ぐ	ふさぐ	close; shut
記号	きごう	symbol; mark
大文字	おおもじ, だいもんじ	upper case letters; large characters; capital letter
置き換える	おきかえる	to replace; to move; to change the position of
歯茎	はぐき	gums; teethridge
根本	こんぽん	basis; root
舌	した	tongue
くっ付ける	くっつける	join; paste
無理やり	むりやり	by force; against one's will
用意	ようい	prepare; ready oneself
因みに	ちなみに	by the way; in this connection; incidentally; in passing
合わせる	あわせる	to match, to put together; to adapt; to fit
あくまで	あくまで	to the end; to the last; stubbornly
其々	それぞれ	each; respective
前歯	まえば	front tooth
唇	くちびる	lip; lips
唇音	しんおん	labial sound
息	いき	breath
鼻音	びおん	nasal sound; nasal
昆布	こんぶ, こぶ	kombu (any kelp of genus Laminaria) (konbu); devil's apron
当てる	あてる	to hit; to apply; to guess (right)
仙台	せんだい	Sendai (city)
信頼	しんらい	reliance; trust; faith; confidence
破る	やぶる	to defeat; to tear; to break through
貫通	かんつう	pierce; penetrate; perforate
洗剤	せんざい	detergent; cleanser
感知	かんち	perception
新人	しんじん	newcomer; freshman
口蓋	こうがい	palate
合体	がったい	union; coalescence; amalgamation; combination; alliance; annexation; copulation
カンニング	カンニング	cheating
軟口蓋	なんこうがい	soft palate
満開	まんかい	full bloom
進学	しんがく	entering a school of higher grade
半額	はんがく	half; half-amount; half price
鼻濁音	びだくおん	nasal sound
衝撃	しょうげき	shock; crash; impact; ballistic
調音	ちょうおん	articulation
其れと	それと	And one more thing
語末	ごまつ	end of a word; suffix
通常	つうじょう	common; ordinary
系	けい	system; lineage; group; corollary; (taxonomical) series
実用	じつよう	practical use; utility
恋愛	れんあい	love; passion; emotion
簡易	かんい	simplicity; convenience; easiness; quasi-
卵黄	らんおう	egg yolk
半母音	はんぼいん	semivowel
談話	だんわ	a talk; conversation
摩擦音	まさつおん	fricative sound
国産	こくさん	domestically produced
紳士	しんし	gentleman
焼く	やく	to grill; to bake; to burn; to be envious
集める	あつめる	to collect; to gather
消える	きえる	to vanish; to disappear
消す	けす	to turn off; erase; delete; put out
沸く	わく	boil; be excited
回す	まわす	to turn; to rotate; to circulate
回る	まわる	to turn; to revolve
曲げる	まげる	to bend; to curve; to lean
敵	てき	enemy; foe
現れる	あらわれる	to appear; to come in sight; to become visible; to come out; to materialize; to be expressed (e.g. emotions); to become apparent (e.g. trends, effects); to emerge
表れる	あらわれる	to appear
姿を現す	すがたをあらわす	to make an appearance; to show up
起こす	おこす	to cause; to wake someone
起きる	おきる	get up; get out of bed; occur (event)
折る	おる	break off; fold; bend
折れる	おれる	snap; be folded; give in
並べる	ならべる	line up; display; set up
並ぶ	ならぶ	line up; be parallel
無くす	なくす	lose; get rid of
無くなる	なくなる	to disappear; to run short; to get lost
計画を立てる	けいかくをたてる	make a plan
割る	わる	to divide; to cut; to break; to halve; to separate; to split
割れる	われる	crack; be divided; split
涙腺	るいせん	lachrymal or tear gland
緩い	ゆるい	loose; lenient; slow
安心	あんしん	peace of mind; relief
詳細情報	しょうさいじょうほう	detailed information
平方	へいほう	square (e.g. meters)
煙	けむり	smoke; fumes
脱線	だっせん	derailment
両	りょう	both (prefix)
倒れる	たおれる	to collapse; to fall
線路	せんろ	line; track
逮捕する	たいほする	arrest
原因	げんいん	cause; origin
同期	どうき	synchronous; same period; employees who joined the same year
道具	どうぐ	tool
跳ねる	はねる	leap; hop; bound
撥ねる	はねる	run over; hit
平均	へいきん	average; equilibrium
国連	こくれん	United Nations
気象	きしょう	weather; climate
お祝い	おいわい	celebrate; congratulatory gift
大臣	だいじん	minister
総理大臣	そうりだいじん	prime minister
太平洋	たいへいよう	Pacific Ocean
成長	せいちょう	growth; grow to adulthood
核兵器	かくへいき	nuclear weapons
実験	じっけん	experiment
資料館	しりょうかん	museum; reference library; archive; record office
世界大戦	せかいたいせん	the World War
第二次世界大戦	だいにじせかいたいせん	World War II
原爆	げんばく	atomic bomb
地球	ちきゅう	the Earth
満月	まんげつ	full moon
気象庁	きしょうちょう	Meteorological Agency
東北地方	とうほくちほう	Tohoku (region)
沖縄県	おきなわけん	Okinawa prefecture (including Okinawa island)
国立	こくりつ	national
天文台	てんもんだい	astronomical observatory
首相	しゅしょう	prime minister
様子	ようす	appearance; aspect; state; condition
崩れる	くずれる	crumble; collapse
洋式	ようしき	Western style
和式	わしき	Japanese style
環境省	かんきょうしょう	Ministry of the Environment
文部科学省	もんぶかがくしょう	Ministry of Education, Culture, Sports, Science and Technology; MEXT
年寄り	としより	old person; older councilor
差別	さべつ	discrimination
珊瑚	さんご	coral
礁	ショウ	reef; sunken rock
温度	おんど	temperature
石垣	いしがき	stone wall
車いす	くるまいす	wheelchair; folding push-chair
障害	しょうがい	obstacle; disorder
機械	きかい	machine
光線	こうせん	beam; light ray
戦う	たたかう	wage war; fight
社会	しゃかい	society
大震災	だいしんさい	great earthquake (disaster)
東日本大震災	ひがしにほんだいしんさい	Tohoku earthquake
香り	かおり	perfume; fragrance
差	さ	difference
福岡	ふくおか	Fukuoka (city)
穴	あな	hole; cavity
水道	すいどう	water service; channel
管	くだ	pipe; tube
情報学	じょうほうがく	informatics
研究所	けんきゅうじょ	research establishment (institute, laboratory, etc.)
入学試験	にゅうがくしけん	(college) entrance exam
目標	もくひょう	target; goal; mark; objective
手続き	てつづき	procedure; formalities
麻薬	まやく	narcotic drugs
犯罪	はんざい	offense; crime
書き込む	かきこむ	to fill in (field, entry, etc.); to fill out (form); to store
卒論	そつろん	graduation thesis; bachelor's degree thesis
制作	せいさく	work (film, book)
母語話者	ぼごわしゃ	native speaker
回答	かいとう	reply; answer
拡散	かくさん	scattering; diffusion; spread (e.g. signal across the spectrum)
関東地方	かんとうちほう	Kanto region (inc. Tokyo, Kanagawa, Saitama, Gunma, Tochigi, Ibaraki and Chiba prefectures)
都	と	large city
県	けん	prefecture (of Japan); county (of China)
流行	りゅうこう	fashion; trend
横綱	よこづな	sumo grand champion
相撲	すもう	sumo wrestling
大相撲	おおずもう	professional sumo match
千代	せんだい, ちよ	thousand years; very long period; forever
駆ける	かける	gallop; run quickly
駆け付ける	かけつける	to run to; to come running; to rush (someplace); to hasten
警護	けいご	bodyguard; escort
戦争	せんそう	war; battle
自衛隊	じえいたい	Self Defense Forces
武器	ぶき	weapon; arms
襲う	おそう	to raid; to attack; to assail; to make an assault; to strike
検察庁	けんさつちょう	Public Prosecutor's Office
起訴	きそ	prosecution; indictment
秘書官	ひしょかん	minister's secretary
罪	つみ	crime; sin
財団	ざいだん	foundation
協力	きょうりょく	cooperation; collaboration
硬貨	こうか	coinage
行事	ぎょうじ	event; function
坊さん	ぼうさん	Buddhist priest
祈り	いのり	prayer
板	いた	board; plank
流行語	りゅうこうご	buzzword; vogue word; popular phrase
新語	しんご	new word; neologism; word of recent origin; recent word; modern term
大賞	たいしょう	big prize; first prize
賞	しょう	prize; award
解散	かいさん	breakup; dissolution
警備	けいび	defense; security
端末	たんまつ	computer terminal; device (smartphone, tablet, etc.)
食料品	しょくりょうひん	foodstuff; groceries
賞金	しょうきん	prize; monetary award
直径	ちょっけい	diameter
量	りょう	quantity; volume
侍	さむらい	samurai; warrior
甲	かぶと	helmet (of armor, armour); headpiece
塊	かたまり	lump; ingot
辻斬り	つじぎり	killing a passerby in order to test a new sword
決定	けってい	decision; settlement
題	だい	title; topic
未発表	みはっぴょう	unpublished; not yet announced
満載	まんさい	fully loaded; full load; loaded condition
収録	しゅうろく	compilation; editing; recording
詳細	しょうさい	details; particulars
追って	おって	later on; shortly; presently; afterwards; in due course; by and by; P.S.
盛り	さかり	peak (of season); prime (of life)
後程	のちほど	later; afterward
沖	おき	open sea; offshore
弱	じゃく	weakness; the weak; little less than
市	し	city
揺れる	ゆれる	to shake; to sway
中国地方	ちゅうごくちほう	Chugoku region of western Honshu (inc. Okayama, Hiroshima, Shimane, Tottori and Yamaguchi prefectures)
警報	けいほう	alarm; warning
津波警報	つなみけいほう	tsunami warning
鉄道	てつどう	railway
経営	けいえい	management; administration; operation; running (business); conducting
区間	くかん	section (of track, etc.); segment; dimension
仏像	ぶつぞう	Buddha statue
液体	えきたい	liquid; fluid
事件	じけん	event; affair; case; incident
宝	たから	treasure
神宮	じんぐう	Shinto shrine
厚生労働省	こうせいろうどうしょう	Ministry of Health, Labor and Welfare
文化庁	ぶんかちょう	the Agency for Cultural Affairs
市町村	しちょうそん	cities, towns and villages; municipalities
栃木県	とちぎけん	Tochigi prefecture (Kantou area)
茨城県	いばらきけん	Ibaraki prefecture (Kantou area)
福島県	ふくしまけん	Fukushima prefecture (Touhoku area)
宮城県	みやぎけん	Miyagi prefecture (Touhoku area)
青森県	あおもりけん	Aomori prefecture (Touhoku area)
千葉県	ちばけん	Chiba prefecture
岩手県	いわてけん	Iwate prefecture (Touhoku area)
奈良県	ならけん	Nara prefecture (Kinki area)
展開	てんかい	unfolding; development
応援	おうえん	support; cheering
寄付	きふ	donation; contribution
運動場	うんどうじょう	playground; sports field
大リーグ	だいリーグ	the major leagues (baseball)
礼	れい	thanking; expression of gratitude
台湾	たいわん	Taiwan
航空	こうくう	aviation
成田空港	なりたくうこう	Narita Airport
関西	かんさい	Kansai (region)
旭	あさひ	morning sun
料金	りょうきん	charge; fee
航空会社	こうくうがいしゃ	airline company
凍る	こおる	freeze; congeal
手帳	てちょう	pocketbook; memo
母子手帳	ぼしてちょう	maternal and child health handbook
国際会議	こくさいかいぎ	international conference
妊娠	にんしん	pregnancy; conception
団体	だんたい	group; corporation
国際的	こくさいてき	international
移動	いどう	movement; transfer; migration; removal; travel<br/>mobile; moving; traveling; travelling; roving
放送局	ほうそうきょく	broadcasting office
動かす	うごかす	to move; to shift; to move (e.g. feeling); to operate; to set in motion
乳房	ちぶさ, にゅうぼう	breast; nipple; udder
治療	ちりょう	medical treatment
勇気	ゆうき	courage; nerve
豊か	ゆたか	abundant; ample
愛す	あいす	to love
支配	しはい	control; management
感染症	かんせんしょう	infectious disease; infection
漁港	ぎょこう	fishing harbour; fishing harbor
漁業	ぎょぎょう	fishing industry
組合	くみあい	union; guild
協同組合	きょうどうくみあい	cooperative; partnership
教授	きょうじゅ	professor
計算	けいさん	calculation
予想	よそう	expectation; anticipation; prediction
癌	ガン	cancer
乳癌	にゅうがん	breast cancer
映画祭	えいがさい	film festival
東南	とうなん, ひがしみなみ	south-east
東北	とうほく	Tohoku Region
西北	せいほく	north-west
西南	せいなん, にしみなみ	south-west
南東	なんとう	southeast
北東	ほくとう	northeast
北西	ほくせい	northwest
南西	なんせい	southwest
国際交流	こくさいこうりゅう	international exchange
記者	きしゃ	journalist; reporter
材料	ざいりょう	ingredients; material
意見	いけん	opinion
水族館	すいぞくかん	aquarium
倒す	たおす	to bring down; to overthrow; to defeat
社会主義	しゃかいしゅぎ	socialism
ミサイル	ミサイル	missile
注目	ちゅうもく	attention; notice
城	しろ	castle; fort
防災	ぼうさい	disaster prevention
高知県	こうちけん	Kouchi (Kochi) prefecture (Shikoku)
黒潮	くろしお	Japan Current; Kuroshio Current
議長	ぎちょう	chairman (of assembly, board); president (of senate, council); moderator
宣言	せんげん	declaration; proclamation; announcement
確り	しっかり	firmly; tightly; reliable; level-headed; steady
容疑	ようぎ	suspect; charge
容疑者	ようぎしゃ	suspect (person)
覚醒剤	かくせいざい	stimulant
疑い	うたがい	doubt; suspicion
逮捕	たいほ	arrest; capture
逮捕される	たいほされる	to be arrested
禁止	きんし	prohibition; forbiddance
尿	にょう	urine
飛鳥	あすか	Asuka
飛鳥	ひちょう	flying bird
香港	ほんこん	Hong Kong
新潟県	にいがたけん	Niigata prefecture (Hokuriku area)
農場	のうじょう	farm (agriculture)
型	かた	model; type; mold (mould)
殺す	ころす	To kill; to smother
以内	いない	within; inside of; less than
家鴨	あひる	domestic duck
日光	にっこう	sunshine; sunlight
東照宮	とうしょうぐう	Toshogu Shrine
彫刻	ちょうこく	carving; engraving; sculpture
江戸時代	えどじだい	Edo period (1603-1868 CE)
国宝	こくほう	national treasure
絵の具	えのぐ	colors; paints
取れる	とれる	to come off; to be removed; to be produced (crops)
緊張	きんちょう	tension; mental strain; nervousness
態度	たいど	attitude; manner
争い	あらそい	conflict; battle
火事	かじ	a fire
製品	せいひん	manufactured goods
器具	きぐ	utensil; implement
石油	せきゆ	petroleum; oil
灯油	とうゆ	kerosene; lamp oil
零れる	こぼれる	spill; overflow
火がつく	ひがつく	to catch fire; to provoke; to catch fire from; to be ignited
干す	ほす	dry; desiccate
燃える	もえる	to burn; to get fired up
議会	ぎかい	assembly; council
与党	よとう	ruling (government) party
野党	やとう	opposition party
政治	せいじ	politics
混乱	こんらん	disorder; confusion
方法	ほうほう	method; procedure
大勢	おおぜい	large numbers; a lot of (people)
世論	よろん, せろん	public opinion
調査	ちょうさ	investigation; inquiry
世論調査	よろんちょうさ	public opinion poll
大会	たいかい	mass meeting; tournament
優勝	ゆうしょう	victory; championship
監督	かんとく	director; supervisor; supervision; control
異常	いじょう	strangeness; abnormality; disorder
競技	きょうぎ	match; sporting event
組織	そしき	organization; construction; tissue; system
委員会	いいんかい	committee
水上	すいじょう	aquatic; on the water
水上競技	すいじょうきょうぎ	water sports
結果	けっか	result; outcome
練習	れんしゅう	practice
場所	ばしょ	place; space
水泳	すいえい	swimming
有明	ありあけ	dawn (sometimes esp. in ref. to the 16th day of the lunar month onward)
神奈川県	かながわけん	Kanagawa prefecture (Kantou area)
覆う	おおう	to cover; to hide; to conceal
原子	げんし	atom
核	かく	core; atomic nucleus
原子核	げんしかく	nucleus (atomic)
原子炉	げんしろ	atomic reactor; nuclear reactor
発電	はつでん	generation of electricity
発電機	はつでんき	dynamo; power generator
放射能	ほうしゃのう	radioactivity
式	しき	ceremony
料理	りょうり	cooking; cookery; cuisine
食事	しょくじ	meal
不正	ふせい	injustice; fraud
経済	けいざい	economy; economics
新聞社	しんぶんしゃ	newspaper office
警察	けいさつ	police
押切	おしきり	straw cutter; short mane; pressing and cutting
携帯電話	けいたいでんわ	cell phone
女優	じょゆう	actress
生産	せいさん	production
リーマンショック	リーマンショック	2008 world economic crisis (Lehman Brothers bankruptcy)
女給	じょきゅう	waitress; hostess
美人	びじん	beautiful woman
対策	たいさく	counter-measure; counter-plan
一覧	いちらん	at a glance; (a) look; (a) glance; (a) summary; (school) catalog; catalogue
一般的	いっぱんてき	common; commonplace; popular; typical; general
呼吸	こきゅう	breathing; respiration
困難	こんなん	difficulty; hardship
呼吸困難	こきゅうこんなん	labored breathing; laboured breathing; dyspnea; dyspnoea
服用	ふくよう	take (medicine)
体験	たいけん	personal experience
自ら	みずから	personally; oneself
思い込み	おもいこみ	wrong impression; subjective impression; assumption; prejudice
立場	たちば	standpoint; position
決めつける	きめつける	to fix upon (one-sidedly); to scold; to take (a person) to task
心中	しんちゅう	in one's heart; true motives; mind
察す	さっす	to guess; to sense; to presume; to judge; to sympathize with
察する	さっする	to guess; to sense; to presume; to judge; to sympathize with
皇太子	こうたいし	crown prince
国王	こくおう	king
希望	きぼう	hope; wish; aspiration
軍	ぐん	army; troops
資格	しかく	qualifications; competence
尊敬	そんけい	respect; esteem; honor
クーデター	クーデター	coup d'etat; coup
映画館	えいがかん	movie theater; cinema
北京	ぺきん	Beijing (China); Peking
売り上げ	うりあげ	sales; proceeds
無形	むけい	abstract; immaterial; moral; spiritual; intangible
文化遺産	ぶんかいさん	cultural heritage
屋台	やたい	street stall; stand
鉾	ほこ	long-handled Chinese spear; lance; pike; weapon; arms; grip of a bow
お祭り	おまつり	festival
飾り	かざり	ornament; decoration
山車	だし	float; a pageant
町	まち	town; block; city quarter
福岡県	ふくおかけん	Fukuoka prefecture (Kyuushuu)
博多祇園山笠	はかたぎおんやまかさ	festival held in July in Fukuoka City
岐阜県	ぎふけん	Gifu prefecture (Chuubu area)
京都府	きょうとふ	Kyoto prefecture (of the 府 kind, as it is a seat of the central government, together with Osaka, and a metropolitan area)
祇園祭	ぎおんまつり	Gion Festival (in Kyoto during the month of July, with high point on the 17th)
風流	ふうりゅう	elegance; taste; refinement
和紙	わし	Japanese paper
全部	ぜんぶ	all; wholly; all in all
布団	ふとん	futon; bedquilt
洗濯	せんたく	laundering; washing
輸入	ゆにゅう	import
庁	ちょう	public office; agency
細かく	こまかく	minutely; finely
洗濯機	せんたくき	washing machine
桶	おけ	bucket
四角形	しかくけい	square; quadrilateral; quadrangle
縦	たて	vertical; length; height
横	よこ	side; width across; horizontal
線	せん	line
印刷	いんさつ	printing
暖房	だんぼう	heating
背もたれ	せもたれ	back (of a chair)
必需品	ひつじゅひん	essential items; necessities
紅白	こうはく	red and white; colours for festive or auspicious occasions (colors)
社会人	しゃかいじん	member of society; working person
表彰	ひょうしょう	public acknowledgment; public acknowledgement; public recognition; commendation
抜く	ぬく	to extract; to omit
翌年	よくねん	the following year
編集	へんしゅう	editing; compilation
公休日	こうきゅうび	legal holiday
締め日	しめび	time limit; closing day; deadline
境	さかい	boundary; border
天皇	てんのう	emperor of Japan
天皇誕生日	てんのうたんじょうび	Emperor's Birthday Holiday (Dec 23rd) (Emperor Shouwa's was April 29th)
関東	かんとう	Kanto (region)
賑わう	にぎわう	bustle; enliven
時点	じてん	point in time; occasion
給油	きゅうゆ	supply of oil
陽射し	ひざし	sunlight; rays of the sun
絶好	ぜっこう	best; ideal; perfect
日和	ひより	weather
暮れる	くれる	to grow dark; to come to an end; to run out; to be sunk (e.g. in despair or grief); to be lost
導	ドウ, みちび.く	guidance; leading; conduct; usher
主導権	しゅどうけん	hegemony; leadership; initiative
目立つ	めだつ	stand out; be conspicuous
角度	かくど	angle
細かい	こまかい	minute; minor; trivial
触れ込み	ふれこみ	(exaggerated) professing to be; passing oneself off as
お札	おさつ	bill; note (currency)
偽	にせ	imitation; fake; phony; counterfeit; forged; bogus; sham
取り替える	とりかえる	to exchange; to replace
影響	えいきょう	influence; effect
宇宙旅行	うちゅうりょこう	space travel
旅行会社	りょこうがいしゃ	travel agency
愛知県	あいちけん	Aichi prefecture (Chuubu area)
名古屋	なごや	Nagoya (city)
乗り物	のりもの	vehicle; conveyance
滑走路	かっそうろ	runway
重力	じゅうりょく	gravity
布	ぬの	cloth
模様	もよう	pattern; design
拍手	はくしゅ	applause; clapping
憲法	けんぽう	constitution; constitutional law
投票	とうひょう	vote; ballot
上院	じょういん	Upper House; Senate; Lords
下院	かいん	lower house; lower (legislative) body
案	あん	plan; proposal
政党	せいとう	political party
運動	うんどう	motion; exercise
責任	せきにん	responsibility; liability
一挙	いっきょ	one effort; one action
話題	わだい	topic of conversation
恥	はじ	shame; disgrace
池袋	いけぶくろ	Ikebukuro (district in Tokyo)
家事	かじ	housework; domestic duties
代わりに	かわりに	instead of; in return; make up for
許可	きょか	permission; approval
大阪市	おおさかし	Osaka city
契約	けいやく	contract; agreement
時速	じそく	speed per hour
攻撃	こうげき	attack; criticism
真珠	しんじゅ	pearl
湾	わん	bay; gulf
基地	きち	base; military base
太平洋戦争	たいへいようせんそう	Pacific War (of World War II)
軍艦	ぐんかん	warship
上手い	うまい	good at
関係ない	かんけいない	have nothing to do with (something); have no connection with (something)
裁判	さいばん	trial; judgment
裁判所	さいばんしょ	courthouse
憲法裁判所	けんぽうさいばんしょ	constitutional court
固まる	かたまる	harden; solidify
凹む	へこむ	be dented; cave in; be snubbed; become depressed
細い	ほそい	thin; slender
掃除	そうじ	cleaning
棒	ぼう	rod; stick
パクチー	パクチー	coriander; cilantro; dhania; Chinese parsley (Coriandrum sativum)
独特	どくとく	peculiarity; uniqueness
味	あじ	taste; flavor
野菜	やさい	vegetable
ベトナム	ベトナム	Vietnam
美容	びよう	beauty treatment
温泉	おんせん	hot spring
地図	ちず	map; atlas
観光	かんこう	sightseeing
湯気	ゆげ	steam; vapor
両親	りょうしん	parents
大分県	おおいたけん	Ooita (Oita) prefecture (Kyuushuu)
群馬県	ぐんまけん	Gunma prefecture (Kantou area)
お土産	おみやげ	souvenir
包む	つつむ	wrap; pack
寺	てら	Buddhist temple
地蔵	じぞう	Ksitigarbha (bodhisattva who looks over children, travellers and the underworld) (travelers)
墓	はか	gravesite; tomb
打付ける	ぶつける	run into; strike hard; try (an idea) on someone
可能性が高い	かのうせいがたかい	very likely; very probable
謝る	あやまる	to apologize
病気	びょうき	illness
呼ばれる	よばれる	to be called (a name); to be referred to (as); to be invited to
多く	おおく	much; largely
新聞	しんぶん	newspaper
読解力	どっかいりょく	reading comprehension; ability to read and understand
学力	がくりょく	scholastic performance; academic ability
科学	かがく	science
文章	ぶんしょう	sentence; writing; prose
地域	ちいき	region; area
高校	こうこう	high school
意見を言う	いけんをいう	to state one's opinion
しっかり	しっかり	mature; reliable; level-headed
棚	たな	shelf; ledge; rack; mount; mantle; trellis
川崎	かわさき	Kawasaki (city)
倉庫	そうこ	warehouse; storehouse
箱	はこ	box; chest; case; bin; railway car
歩く	あるく	to walk; go on foot
速い	はやい	fast
交通	こうつう	traffic; transportation
機関	きかん	engine; agency; organization
交通事故	こうつうじこ	traffic accident
交通機関	こうつうきかん	means of transportation
遭う	あう	to meet; to encounter; to have a bad experience
抗生物質	こうせいぶっしつ	antibiotic
生死	せいし	life and death
文房具	ぶんぼうぐ	stationery; writing materials
放ったらかし	ほったらかし	neglecting; leaving alone
放ったらかしにする	ほったらかしにする	to neglect; to let alone
放ったらかす	ほったらかす	to let aside; to neglect
成功	せいこう	[n.; suru] success; hit
相反	そうはん	[n.] reciprocality
利益相反	りえきそうはん	[n.] conflict of interest
後悔	こうかい	[n.; suru; no-n.] regret; repentance; remorse
買い物	かいもの	[n.; no-n.] shopping; purchased goods
子ども	こども	[n.] child; children
多い	おおい	[adj.] many; numerous
入れる	いれる	[v1.; vt.] to put in; to let in; to take in; to bring in; to insert; to set (a jewel, etc.); to ink in (e.g. a tattoo) // [n.] to admit; to accept; to employ; to hire // [n.] to accept; to comply; to grant; to adopt (a policy, etc.); to take (advice, etc.); to listen to; to pay attention to // [n.] to include // [n.] to pay (one's rent, etc.) // [n.] to cast (a vote) // [n.] to make (tea, coffee, etc.) // [n.] to turn on (a switch, etc.) // [n.] to send (a fax); to call
座る	すわる	[v5ru.; vi.] to sit; to squat // [n.] to assume (a position) // [n.] to hold steady; to hold still
国民生活	こくみんせいかつ	[n.] the life of the people; the people's living
病	やまい	[n.] illness; disease // [n.] bad habit; weakness; fault
院	いん	[n.] house of parliament (congress, diet, etc.) // [n.] graduate school; postgraduate school // [suffix] institution (often medical); institutional building; government office // [n.] sub-temple; minor temple building; temple; cloister // [n.; sonkeigo] imperial palace // [sonkeigo; arch.] title bestowed on empresses, princesses, etc. // [suffix] former (esp. of emperors, daimyos, etc.); late
病院	びょういん	[n.; no-n.] hospital
聞く	きく	[v5ku.; vt.] to hear // [n.] to listen (e.g. to music) // [n.] to ask; to enquire; to query // [n.] to learn of; to hear about // [n.] to follow (advice); to comply with // [n.] to smell (esp. incense); to sample fragrance
歳	さい	[suffix] -years-old // [n.] ability; gift; talent; aptitude; genius
今年	ことし,こんねん	[advn.; tempn.] this year
約	やく	[adv.] approximately; about // [n.] promise // [n.] shortening; reduction; simplification // [n.] contraction (in phonetics)
年	とし	[n.] year // [n.] age; years // [n.] past one's prime; old age
年	ねん	[n.] year (e.g. AD) // [cnt.] counter for years
半	はん	[n.; prefn.] half; semi- // [n.; sufn.] half-past // [n.] odd number // [arch.] unit of land area (595.8 m^2)
回	かい	[cnt.] counter for occurrences // [n.] counter for games, rounds, etc.; counter for innings (baseball) // [n.; prefn.] Islam // [n.; abbr.] Hui (people)
頭	とう	[cnt.] counter for large animals (e.g. head of cattle)
頭	あたま,かしら	[n.] head // [n.] hair (on one's head) // [n.] mind; brains; intellect // [n.] leader; chief; boss; captain // [n.] top; tip // [n.] beginning; start // [n.] head; person // [n.] top structural component of a kanji
顔	かお,がん	[n.] face; visage // [n.] look; expression; countenance // [n.] honor; honour; face // [n.] influence; notoriety
骨が折れる	ほねがおれる	[phrase; v1.] to require much effort; to be hard to do
強い	つよい	[adj.] strong; powerful; mighty; potent // [n.] resistant; resilient; durable
打つ	うつ	[v5tsu.; vt.] to hit; to strike; to knock; to beat; to punch; to slap; to tap; to bang; to clap; to pound // [n.] to strike (noon, etc.); to sound (cymbals, etc.); to beat (a drum, etc.) // [n.] to beat (rhythmically, e.g. pulse, waves, etc.) // [n.] to move; to impress; to touch // [n.] to drive in; to hammer in; to put in; to inject // [n.] to type; to send; to transmit // [n.] to insert; to write in; to mark // [n.] to make (noodles, etc.); to prepare // [n.] to till (soil) // [n.] to sprinkle; to throw; to cast // [n.] to do; to carry out; to play; to perform; to engage in (gambling, etc.) // [n.] to pay (a deposit, etc.) // [n.] to visit (on a pilgrimage) // [n.] to line (a coat) // [n.] to bind (a criminal)
打つ	ぶつ	[v5tsu.; vt.; us. kana] to hit (a person); to strike; to beat
床	とこ	[n.] bed; bedding // [n.] sickbed // [abbr.] alcove // [n.] riverbed // [n.] seedbed // [n.] straw "core" of a tatami mat // [n.] floor
床	ゆか	[n.] floor // [n.] stage (for the narrator and the shamisen player) // [n.] dining platform built across a river
床	しょう	[cnt.] counter for beds
コンクリート	こんくりいと,コンクリート	[n.; us. kana] concrete
同じ	おなじ,おんなじ	[n./prenv.; n.] same; identical; equal; uniform; equivalent; similar; common (origin); changeless; alike // [adv.] (usu. part of a 'nara' conditional) anyway; anyhow; in either case
所	ところ,とこ	[n.; suffix] place; spot; scene; site // [us. kana] address // [us. kana] district; area; locality // [us. kana] one's house // [us. kana] point // [us. kana] part // [us. kana] space; room // [us. kana] thing; matter // [n.; us. kana] whereupon; as a result // [us. kana] about to; on the verge of // [us. kana] was just doing; was in the process of doing; have just done; just finished doing
所	しょ	[suffix; cnt.] counter for places
上	うえ	[n.; no-n.; advn.; sufn.] above; up; over; elder (e.g. daughter) // [n.] top; summit // [n.] surface; on // [n.] before; previous // [n.] superiority; one's superior (i.e. one's elder) // [n.] on top of that; besides; what's more // [n.] upon (further inspection, etc.); based on (and occurring after) // [n.] matters concerning...; as concerns ... // [n.] since (i.e. "for that reason") // [sufn.; sonkeigo] suffix indicating higher social standing // [arch.] place of one's superior (i.e. the throne) // [arch.] emperor; sovereign; shogun; daimyo // [arch.] noblewoman (esp. the wife of a nobleman)
立つ	たつ	[v5tsu.; vi.] to stand; to rise; to stand up // [n.] to find oneself (e.g. in a difficult position) // [n.] to depart (on a plane, train, etc.)
気	き	[n.] spirit; mind; heart // [n.] nature; disposition // [n.] motivation; intention // [n.] mood; feelings // [n.] ambience; atmosphere; mood
気をつける	きをつける	[phrase; v1.] to be careful; to pay attention; to take care
気をつけて	きをつけて	[phrase] take care; be careful
話す	はなす	[v5su.; vt.] to talk; to speak; to converse; to chat // [n.] to tell; to explain; to narrate; to mention; to describe; to discuss // [n.] to speak (a language)
前	まえ	[advn.; tempn.; suffix] ago; before (some event); previously; (minutes) to (the hour) // [n.] in front (of); before (e.g. the house) // [n.] head (of a line); front (e.g. of a bus); fore part // [n.] in the presence of // [n.] helping; portion // [n.] privates; private parts
ランドセル		[n.] firm-sided backpack made of leather, etc. (used by Japanese elementary schoolchildren, often red for girls and black for boys)
私	わたし,わたくし	[pron.; no-n.] I; me // [n.; no-n.] private affairs; personal matter; secrecy // [n.] selfishness
家族	かぞく	[n.; no-n.] family; members of a family
一緒に	いっしょに	[adv.] together (with); at the same time; in a lump
個	こ,コ	[cnt.] counter for articles // [n.] counter for military units // [n.] individual
プロレス		[n.; abbr.] professional wrestling
タイガー		[n.] tiger (feline, Panthera tigris)
名前	なまえ	[n.] name; full name // [n.] given name; first name
書く	かく	[v5ku.; vt.] to write; to compose; to pen // [n.] to draw; to paint
誰	だれ,たれ,た	[pron.; no-n.] who
夜	よる,よ	[advn.; tempn.] evening; night
来る	くる	[vkuru.; vi.] to come (spatially or temporally); to approach; to arrive // [vkuru.; vi.; auxv.] to come back; to do ... and come back // [n.] to come to be; to become; to get; to grow; to continue // [vkuru.; vi.] to come from; to be caused by; to derive from // [n.] to come to (i.e. "when it comes to spinach ...")
自分	じぶん	[pron.; no-n.] myself; yourself; oneself; himself; herself // [n.] I; me // [n.] you
言う	いう,ゆう	[v5u.] to say; to utter; to declare // [n.] to name; to call // [n.] to go (e.g. "the alarm went ping"); to make a noise
小さい	ちいさい	[adj.] small; little; tiny
持つ	もつ	[v5tsu.] to hold (in one's hand); to take; to carry // [n.] to possess; to have; to own // [n.] to maintain; to keep // [n.] to last; to be durable; to keep; to survive // [n.] to take charge of; to be in charge of
同じよう	おなじよう	[adjn..] similar
人	ひと,ヒト	[n.] man; person // [n.] human being; mankind; people // [us. kana] human (Homo sapiens); humans as a species // [n.] character; personality // [n.] man of talent; true man // [n.] another person; other people; others // [n.] adult
京都	きょうと	[n.] Kyoto
暖かい	あたたかい,あったかい	[adj.] warm; mild; genial
ストーブ		[n.] (room) heater; stove
列車	れっしゃ	[n.] train (ordinary)
乗る	のる	[v5ru.; vi.] to get on (train, plane, bus, ship, etc.); to get in; to board; to take; to embark // [n.] to get on (e.g. a footstool); to step on; to jump on; to sit on; to mount // [n.] to reach; to go over; to pass // [n.] to follow; to stay (on track); to go with (the times, etc.) // [n.] to take part; to participate; to join // [n.] to get into the swing (and sing, dance, etc.) // [n.] to be deceived; to be taken in // [n.] to be carried; to be spread; to be scattered // [n.] to stick; to attach; to take; to go on
景色	けしき,けいしょく	[n.; no-n.] scenery; scene; landscape
トロッコ		[n.] rail car (esp. a small one used in mines, etc.); trolley
走る	はしる	[v5ru.; vi.] to run // [n.] to travel (movement of vehicles); to drive // [n.] to hurry to // [n.] to retreat (from battle); to take flight // [n.] to run away from home // [n.] to elope // [n.] to tend heavily toward // [n.] to flash; to streak; to shoot through (e.g. pain)
川	かわ,がわ	[n.] river; stream // [suffix] the .... river; (suffix used with the names of rivers)
谷	たに	[n.] valley
見る	みる	[v1.; vt.] to see; to look; to watch; to view; to observe // [n.] to look over; to look on; to assess; to examine; to judge // [us. kana] to look after; to keep an eye on; to take care of // [n.] to view (e.g. flowers, movie) // [auxv.; v1.; us. kana] to try; to try out; to test // [us. kana] to see that...; to find that...
観光客	かんこうきゃく	[n.] tourist
毎年	まいとし,まいねん	[tempn.] every year; yearly; annually
冬	ふゆ	[advn.; tempn.] winter
石炭	せきたん,いしずみ	[n.] coal
駅	えき	[n.] station
始める	はじめる	[v1.; vt.] to start; to begin; to commence; to initiate; to originate // [n.] to open (e.g. a store); to start up; to establish (business. etc.) // [auxv.; v1.] to start ...; to begin to ...
写真	しゃしん	[n.] photograph; photo; picture; snapshot; snap // [n.] movie
撮る	とる	[v5ru.; vt.] to take (a photo) // [n.] to record (video, audio, etc.); to make (a film)
寒い	さむい,さぶい	[adj.] cold (e.g. weather) // [n.] uninteresting (esp. joke); lame; dull; weak; corny
楽しみ	たのしみ	[adjn..; n.] enjoyment; pleasure; diversion; amusement; hobby // [n.] anticipation; looking forward to
インドネシア		[n.; us. kana] Indonesia
州	しゅう	[n.; sufn.] state; province; county; oblast; department (of ancient China) // [n.] continent // [suffix; arch.] dear
マグニチュード		[n.] magnitude
建物	たてもの	[n.] building
家	いえ	[n.] house; residence; dwelling // [n.] family; household // [n.] lineage; family name
店	みせ	[n.] store; shop; establishment; restaurant
兵士	へいし	[n.] soldier
使う	つかう	[v5u.; vt.] to use (a thing, method, etc.); to make use of; to put to use // [n.] to use (a person, animal, puppet, etc.); to employ; to handle; to manage; to manipulate // [n.] to use (time, money, etc.); to spend; to consume // [n.] to use (language); to speak
足りない	たりない	[adj.] insufficient; not enough; lacking // [n.] dim-witted; slow; one brick short of a full load
手	て	[n.] hand; arm // [coll.] forepaw; foreleg // [n.] handle // [n.] hand; worker; help // [n.] trouble; care; effort // [n.] means; way; trick; move; technique; workmanship // [n.] hand; handwriting // [n.] kind; type; sort // [n.] one's hands; one's possession // [n.] ability to cope // [n.] hand (of cards) // [n.] direction // [n.; sufn.; cnt.] move (in go, shogi, etc.)
片づける	かたづける	[v1.; vt.] to tidy up; to put in order; to straighten up; to put away // [n.] to settle (problem); to clear (dispute) // [n.] to finish; to bring something to an end // [n.] to marry off (e.g. a daughter) // [n.] to do away with someone; to bump someone off
時間	じかん	[advn.; n.] time // [cnt.] hours (period of)
医者	いしゃ	[n.; sensitive] (medical) doctor; physician
亡くなる	なくなる	[v5ru.; vi.; us. kana] to be lost (e.g. luggage); to be missing // [us. kana] to be used up; to be run out; to be exhausted; to be consumed; to be reduced to zero; to not occur any more // [us. kana] to disappear (e.g. pain); to be lost (e.g. a dream, confidence)
看護	かんご	[n.; suru] nursing; (army) nurse
師	し	[n.] teacher; master; one's mentor // [n.; suffix] religious leader // [suffix] specialist // [n.; arch.] five-battalion brigade comprising 2500 men (Zhou-dynasty Chinese army)
看護師	かんごし	[n.] (hospital) nurse; registered nurse; RN
出す	だす	[v5su.; vt.] to take out; to get out // [n.] to put out; to reveal; to show // [n.] to submit (e.g. thesis); to turn in // [n.] to publish; to make public // [n.] to send (e.g. letter) // [n.] to produce (a sound); to start (fire) // [n.] to serve (food) // [suffix; v5su.] to begin ...; to start to ...; to burst into ...
今日	きょう,こんにち,こんち,こんじつ	[tempn.] today; this day // [n.] these days; recently; nowadays
ため息	ためいき	[n.] sigh
弾劾	だんがい	[n.; suru; no-n.] impeachment; accusation; censure; denunciation
職務	しょくむ	[n.] professional duties
停止	ていし,ちょうじ	[n.; suru] suspension; interruption; stoppage; ban; standstill; halt; hang-up; deadlock; stalemate; abeyance // [n.] suspension of music, dance, etc. as a sign of mourning for a prominent person
音楽	おんがく	[n.] music; musical movement
出来事	できごと,できこと	[n.] incident; affair; happening; event
事	こと,こん	[n.; us. kana] thing; matter // [us. kana] incident; occurrence; event; something serious; trouble; crisis // [us. kana] circumstances; situation; state of affairs // [us. kana] work; business; affair // [us. kana] after an inflectable word, creates a noun phrase indicating something the speaker does not feel close to // [sufn.; us. kana] nominalizing suffix // [us. kana] pretending to ...; playing make-believe ... // [n.; sufn.; us. kana] alias; aka; nickname; alternative name; also known as
分かる	わかる	[v5ru.; vi.; us. kana] to understand; to comprehend; to grasp; to see; to get; to follow // [us. kana] to become clear; to be known; to be discovered; to be realized; to be realised; to be found out
達	たち	[suffix; us. kana] pluralizing suffix (esp. for people & animals; formerly honorific)
悲惨	ひさん	[adjn..] disastrous; tragic; miserable; wretched; pitiful; woeful
韓国	かんこく	[n.; no-n.; abbr.] South Korea; Republic of Korea // [abbr.] Korean Empire (1897-1910)
戦闘	せんとう	[n.; suru; no-n.] battle; fight; combat
国	くに	[n.] country; state // [n.] region // [n.] national government; central government // [n.] home (i.e. hometown, home country) // [arch.] province (of Japan) // [arch.] land; earth
ノーベル賞	ノーベルしょう	[n.] Nobel Prize
日	ひ	[advn.; tempn.] day; days // [n.] sun; sunshine; sunlight // [n.] case (esp. unfortunate); event
渡す	わたす	[v5su.; vt.] to ferry across (e.g. a river); to carry across; to traverse // [n.] to lay across; to build across // [n.] to hand over; to hand in; to pass; to give; to transfer
否定	ひてい	[n.; suru; no-n.] negation; denial; repudiation; disavowal // [n.] NOT operation
賛成	さんせい	[n.; suru; no-n.] approval; agreement; support; favour; favor
今	いま	[advn.; n.] now; the present time; just now; soon; immediately; (one) more
生理学	せいりがく	[n.] physiology
日本	にほん,にっぽん	[n.] Japan
リサイクル		[n.; suru] recycling
細胞	さいぼう,さいほう	[n.; no-n.] cell
働き	はたらき	[n.] work; labor; labour // [n.] achievement; performance; ability; talent // [n.] salary; income; earnings // [n.] action; activity; workings; function; operation; movement; motion // [n.] conjugation; inflection
文学	ぶんがく	[n.] literature
友達	ともだち	[n.] friend; companion
作る	つくる	[v5ru.; vt.] to make; to produce; to manufacture; to build; to construct // [n.] to prepare (food); to brew (alcohol) // [n.] to raise; to grow; to cultivate; to train // [n.] to till // [n.] to draw up (a document); to make out; to prepare; to write // [n.] to create (an artistic work, etc.); to compose // [n.] to coin (a phrase); to organize; to organise; to establish; to found // [n.] to have (a child) // [n.] to make up (one's face, etc.) // [n.] to fabricate (an excuse, etc.) // [n.] to form (a line, etc.) // [n.] to set (a record) // [n.] to commit (a sin, etc.)
歌	うた	[n.] song // [n.] classical Japanese poetry (esp. tanka) // [n.] modern poetry
歌う	うたう	[v5u.; vt.; vi.] to sing // [v5u.; vt.] to sing (one's praises in a poem, etc.); to compose a poem; to recite a poem
宇宙船	うちゅうせん	[n.] space ship
打ち上げる	うちあげる	[v1.; vt.] to launch; to shoot up // [n.] (of waves) to dash; to wash up (ashore) // [n.] to finish (e.g. a theater run, sumo tournament); to close // [n.] to report (to boss, etc.)
午後	ごご	[advn.; tempn.] afternoon; p.m.
時	とき	[n.] time; hour; moment // [n.] occasion; case // [n.] chance; opportunity; season // [n.] the times; the age; the day // [n.] tense
分	ふん	[n.] minute // [n.] fun (one tenth of a monme, 5.787 grains)
鹿児島県	かごしまけん	[n.] Kagoshima prefecture (Kyushu)
国際	こくさい	[n.; no-n.] international
宇宙	うちゅう	[n.] universe; cosmos; space
国際宇宙ステーション	こくさいうちゅうステーション	[n.] International Space Station
宇宙ステーション	うちゅうステーション	[n.] space station
荷物	にもつ	[n.] luggage; baggage; package // [n.] burden // [n.] payload (of a packet, cell, etc.)
着く	つく	[v5ku.; vi.] to arrive at; to reach // [n.] to sit on; to sit at (e.g. the table)
製	せい	[n.; sufn.] -made; make
日本製	にほんせい	[n.] made in Japan
新しい	あたらしい	[adj.] new; novel; fresh; recent; latest; up-to-date; modern
電源	でんげん	[n.] source of electricity; electrical power // [n.] power (button on TV, etc.)
衛星	えいせい	[n.; no-n.] satellite
人工衛星	じんこうえいせい	[n.] man-made satellite
問題	もんだい	[n.] question (e.g. on a test); problem // [n.] problem (e.g. societal, political); question; issue; subject (e.g. of research); case; matter // [n.] question (i.e. doubt) // [n.] public discussion; controversy // [n.] trouble; problem; inconvenience; difficulty
麒麟	きりん	[n.; us. kana] giraffe (Giraffa camelopardalis) // [n.] qilin (Chinese unicorn) // [n.] Kirin (brand of beer) // [arch.] horse that can ride 1000 ri in a day
いなくなる		[phrase; v5ru.; us. kana] to disappear; to stop being; to leave
高い	たかい	[adj.] high; tall // [n.] expensive
動物	どうぶつ	[n.] animal
自然	しぜん	[adjn..; n.] nature; spontaneity // [adv.; to-adv.] naturally; spontaneously
大切	たいせつ,たいせち	[adjn..; n.] important; necessary; indispensable // [n.] beloved; precious; dear; cherished; valuable // [n.] careful
大切に	たいせつに	[adv.] carefully; with caution; with great care
活動	かつどう	[n.; suru] action; activity // [n.; abbr.; obsolete] movie (esp. during the silent movie period)
絶滅	ぜつめつ	[n.; suru; no-n.] destruction; extinction
危惧	きぐ	[n.; suru] apprehensions; misgivings; uneasiness; anxiety; fear
種	たね	[n.] seed (e.g. of a plant); pip; kind; variety; quality; tone // [n.] material (e.g. for an article); matter (e.g. of a story); subject; theme; (news) copy // [n.] ingredient; leaven (bread); main ingredient of a sushi // [n.] cause; source // [n.] trick; secret; magician's trick; inside story // [n.] paternal blood; lineage // [n.] breed (of a stock); sperm; semen
絶滅危惧種	ぜつめつきぐしゅ	[n.] endangered species
少ない	すくない	[adj.] few; a little; scarce; insufficient; seldom
森	もり	[n.] forest // [n.] shrine grove
木	き	[n.] tree; shrub; bush // [n.] wood; timber
切る	きる	[suffix; v5ru.; vt.] to cut; to cut through; to perform (surgery) // [n.] to sever (connections, ties) // [n.] to turn off (e.g. the light) // [n.] to terminate (e.g. a conversation); to hang up (the phone); to disconnect // [n.] to punch (a ticket); to tear off (a stub) // [n.] to open (something sealed) // [n.] to start // [n.] to set (a limit); to do (something) in less or within a certain time; to issue (stamps, vouchers, etc.) // [n.] to reduce; to decrease; to discount // [n.] to shake off (water, etc.); to let drip-dry; to let drain // [n.] to cross; to traverse // [n.] to criticize sharply // [n.] to act decisively; to do (something noticeable); to go first; to make (certain facial expressions, in kabuki) // [n.] to turn (a vehicle) // [n.] to curl (a ball); to bend; to cut // [n.] to shuffle (cards) // [n.] to dismiss; to sack; to let go; to expulse; to excommunicate // [n.] to dig (a groove); to cut (a stencil, on a mimeograph) // [n.] to trump // [n.] (in Go) to isolate (an opponent's stone) // [n.] to start a fire (with wood-wood friction or by striking a metal against stone) // [n.] to draw (a shape) in the air (with a sword, etc.) // [suffix; v5ru.] to finish; to complete
打ち上げる	ぶちあげる	[v1.; vt.] to make a bold speech; to make a bold statement
長い	ながい	[adj.] long (distance) // [n.] long (time); lengthy
雨	あめ	[n.] rain
降る	ふる	[v5ru.; vi.] to precipitate; to fall (e.g. rain)
食べる	たべる	[v1.; vt.] to eat // [n.] to live on (e.g. a salary); to live off; to subsist on
金曜日	きんようび	[advn.; tempn.] Friday
仕事	しごと	[n.; suru; no-n.] work; job; business; occupation; employment; vocation; task // [n.] work
会社	かいしゃ	[n.] company; corporation // [n.] workplace
旅行	りょこう	[n.; suru; no-n.] travel; trip
お金	おかね	[n.; teineigo] money
元気	げんき	[adjn..; n.] lively; full of spirit; energetic; vigorous; vital; spirited // [n.] healthy; well; fit; in good health
来年	らいねん	[advn.; tempn.] next year
最後	さいご	[n.; no-n.] last; end; conclusion; latest; most recent // [phrase] no sooner than; right after (often having negative consequences) // [arch.] one's final moments
違う	ちがう	[v5u.; vi.] to differ (from); to vary // [n.] to not be in the usual condition // [n.] to not match the correct (answer, etc.) // [n.] to be different from promised // [n.] isn't it?; wasn't it?
売る	うる	[v5ru.; vt.] to sell
呼ぶ	よぶ	[v5bu.; vt.] to call out (to); to call; to invoke // [n.] to summon (a doctor, etc.) // [n.] to invite // [n.] to designate; to name; to brand // [n.] to garner (support, etc.); to gather // [arch.] to take as one's wife
働く	はたらく	[v5ku.; vi.] to work; to labor; to labour // [n.] to function; to operate; to be effective; to work (i.e. ... works); to come into play // [n.] to commit (e.g. a crime); to perpetrate; to do; to act; to practise; to practice // [n.] to be conjugated
早い	はやい	[adj.] fast; quick; hasty; brisk // [n.] early (in the day, etc.); premature // [n.] (too) soon; not yet; (too) early // [n.] easy; simple; quick
帰る	かえる	[v5ru.; vi.] to return; to come home; to go home; to go back // [n.] to leave // [n.] to get home; to get to home plate
香川県	かがわけん	[n.] Kagawa prefecture (Shikoku)
正月	しょうがつ	[n.] New Year (esp. first three days) // [n.] the first month of the year; January
年明け	ねんあけ,としあけ	[n.] beginning of the year; early in the New Year // [n.] expiration of a term of service
有名	ゆうめい	[adjn..] famous // [n.] fame
明ける	あける	[v1.; vt.] to open (a door, etc.); to unwrap (e.g. parcel, package); to unlock // [n.] to open (for business, etc.) // [n.] to empty; to remove; to make space; to make room // [n.] to move out; to clear out // [n.] to be away from (e.g. one's house); to leave (temporarily) // [v1.; vi.] to dawn; to grow light // [n.] to end (of a period, season) // [n.] to begin (of the New Year) // [n.] to leave (one's schedule) open; to make time (for) // [n.] to make (a hole); to open up (a hole)
知る	しる	[v5ru.; vt.] to be aware of; to know; to be conscious of; to cognize; to cognise // [n.] to notice; to feel // [n.] to understand; to comprehend; to grasp // [n.] to remember; to be acquainted with (a procedure) // [n.] to experience; to go through; to learn // [n.] to be acquainted with (a person); to get to know // [n.] to concern
始まる	はじまる	[v5ru.; vi.] to begin; to start; to commence // [n.] to happen (again); to begin (anew) // [n.] to date (from); to originate (in)
朝	あさ,あした	[advn.; tempn.] morning
太陽	たいよう	[n.] sun; solar
昇る	のぼる	[v5ru.; vi.] to ascend; to go up; to climb // [n.] to ascend (as a natural process, e.g. the sun); to rise // [n.] to go to (the capital) // [n.] to be promoted // [n.] to add up to // [n.] to advance (in price) // [n.] to swim up (a river); to sail up // [n.] to come up (on the agenda)
初日の出	はつひので	[phrase] first sunrise (of New Year)
赤い	あかい	[adj.] red // [n.] Red (i.e. communist)
色	いろ	[n.] colour; color // [n.] complexion // [n.] appearance; look // [n.] love; lust; sensuality; love affair; lover // [n.] kind; type; variety
食べ物	たべもの	[n.] food
長崎	ながさき,ナガサキ	[n.] Nagasaki (city) // [n.] atomic bombing of Nagasaki
長崎県	ながさきけん	[n.] Nagasaki prefecture (Kyushu)
梅干し	うめぼし	[n.] umeboshi; pickled ume; pickled plum
麺	めん	[n.] noodles // [arch.] flour
白い	しろい	[adj.] white
入る	はいる	[v5ru.; vi.] to enter; to go into // [n.] to break into // [n.] to join; to enroll // [n.] to contain; to hold; to accommodate // [n.] to have (an income of) // [n.] to get; to receive; to score
漢字	かんじ	[n.] Chinese characters; kanji
万	まん,よろず	[num.] 10,000; ten thousand // [n.; no-n.] myriad // [advn.] everything; all // [n.; no-n.; arch.] various
中	なか	[n.] inside; in // [n.] among; within // [n.] center (centre); middle // [n.] during; while
中	ちゅう	[n.; pref.; suffix] medium; average; middle // [n.] moderation // [abbr.] middle school // [abbr.] China // [abbr.] volume two (of three) // [sufn.] during (a certain time when one did or is doing something); under (construction, etc.); while // [n.] in; out of (e.g. three out of ten people)
中	じゅう,ぢゅう	[suffix] through; throughout; in the course of // [n.] all over or throughout (e.g. a place)
番	ばん	[n.] number (in a series) // [n.] (one's) turn // [n.] watch; guard; lookout // [n.] bout; match
大きな	おおきな	[pren.] big; large; great
紙	かみ	[n.] paper
筆	ふで	[n.] writing brush
日本人	にほんじん,にっぽんじん	[n.] Japanese person; Japanese people
金メダル	きんメダル	[n.] gold medal
取る	とる	[v5ru.; vt.] to take; to pick up; to harvest; to earn; to win; to choose // [n.] to steal // [n.] to eat; to have (a meal) // [n.] to remove (one's glasses, etc.) // [n.] to compete (in sumo, cards, etc.); to play
東京	とうきょう	[n.] Tokyo
知事	ちじ	[n.; no-n.] prefectural governor
階段	かいだん	[n.] stairs; stairway; staircase
非常階段	ひじょうかいだん	[n.] emergency staircase; emergency stairs
今世界	こんせかい	[n.] this world
階	かい	[n.; sufn.] storey; story; floor // [n.] stairs // [n.; sufn.] stage (in chronostratigraphy) // [cnt.] counter for storeys and floors of a building
展望	てんぼう	[n.; suru] view; outlook; prospect
台	だい	[n.; sufn.] stand; rack; table // [n.] support // [n.] belt // [cnt.] counter for machines, incl. vehicles // [n.] setting (e.g. in jewellery) // [n.; sufn.; cnt.] level (e.g. price level); range (e.g. after physical units); period (of time, e.g. a decade of one's life)
展望台	てんぼうだい	[n.] viewing platform
屋上	おくじょう	[n.] rooftop
冷たい	つめたい,つべたい	[adj.] cold (to the touch); chilly; icy; freezing // [n.] coldhearted; unfeeling
体	からだ,しんたい,しんだい,しんてい	[n.; no-n.] body // [n.] torso; trunk // [n.] build; physique; constitution // [n.; no-n.] health // [n.] corpse; dead body
大変	たいへん	[adv.] very; greatly // [adjn..; n.] immense; enormous; great // [n.] serious; grave; dreadful; terrible // [n.] difficult; hard // [arch.] major incident; disaster
レジ		[n.; abbr.] (cash) register // [abbr.] cashier
電化	でんか	[n.; suru] electrification
電化製品	でんかせいひん	[n.] electrical appliances; electric appliances
一緒	いっしょ	[advn.; n.; no-n.] together // [n.] at the same time // [n.] same; identical
欲しい	ほしい	[adj.] wanted; wished for; in need of; desired // [auxadj.; us. kana] I want (you) to
籠	かご,カゴ	[n.; us. kana] basket (shopping, etc.); hamper; cage
読む	よむ	[v5mu.; vt.] to read // [n.] to count // [n.] to guess; to predict; to read (someone's thoughts); to see (e.g. into someone's heart); to divine
持っていく	もっていく,もってゆく	[phrase; v5iku.] to take; to carry (something) away; to bear
幾ら	いくら	[adv.; n.; us. kana] how much?; how many? // [adv.] even; even if
画面	がめん	[n.] terminal screen; scene; picture; the field (in TV); photo
出る	でる	[v1.; vi.] to leave; to exit; to go out; to come out; to get out // [n.] to leave (on a journey); to depart; to start out; to set out // [n.] to move forward // [n.] to come to; to get to; to lead to; to reach // [n.] to appear; to come out; to emerge; to surface; to come forth; to turn up; to be found; to be detected; to be discovered; to be exposed; to show; to be exhibited; to be on display // [n.] to appear (in print); to be published; to be announced; to be issued; to be listed; to come out // [n.] to attend; to participate; to take part; to enter (an event); to play in; to perform // [n.] to be stated; to be expressed; to come up; to be brought up; to be raised // [n.] to sell // [n.] to exceed; to go over // [n.] to stick out; to protrude // [n.] to break out; to occur; to start; to originate // [n.] to be produced // [n.] to come from; to be derived from // [n.] to be given; to get; to receive; to be offered; to be provided; to be presented; to be submitted; to be handed in; to be turned in; to be paid // [n.] to answer (phone, door, etc.); to get // [n.] to assume (an attitude); to act; to behave // [n.] to pick up (speed, etc.); to gain // [n.] to flow (e.g. tears); to run; to bleed // [n.] to graduate
出てくる	でてくる	[vkuru.] to come out; to appear; to turn up; to emerge
底	そこ	[n.] bottom; sole
底	てい,そこ	[n.] base (logarithmic, exponential, number system); radix // [n.] base (triangle, cone, cylinder, etc.) // [arch.] type; kind; extent; degree
下	した	[n.] below; down; under; younger (e.g. daughter) // [n.] bottom // [n.] beneath; underneath // [n.] just after; right after // [n.; no-n.] inferiority; one's inferior (i.e. one's junior) // [n.] trade-in // [prefn.] preliminary; preparatory
下	もと	[adv.] under (esp. influence or guidance)
中国	ちゅうごく	[n.] China // [abbr.] Chugoku region of western Honshu (incl. Okayama, Hiroshima, Shimane, Tottori and Yamaguchi prefectures) // [n.] central part of a country; main region
エレベーター	エレベーター,エレベータ	[n.] elevator; lift // [n.] elevator (aviation)
広州	こうしゅう,コアンチョウ,コワンチョウ	[n.] Guangzhou (China); Kwangchow; Canton
とても	とても,とっても	[adv.; us. kana] very; awfully; exceedingly // [us. kana] (not) at all; by no means; simply (cannot)
上海	シャンハイ	[n.] Shanghai (China)
注文	ちゅうもん	[n.; suru; no-n.] order; request
日夜	にちや	[advn.; n.] day and night; always
東	ひがし,ひむかし,ひんがし	[n.] east
海	うみ	[n.] sea; ocean
飛ぶ	とぶ	[v5bu.; vi.] to fly; to soar // [n.] to jump; to leap; to spring; to bound; to hop
悪い	わるい	[adj.] bad; poor; inferior // [n.] evil; sinful // [n.] unprofitable; unbeneficial // [n.] at fault; to blame; in the wrong // [n.] sorry
調子が悪い	ちょうしがわるい	[phrase; adj.] in bad shape; not doing well; not going well; out of condition; in poor form
急ぐ	いそぐ	[v5gu.; vi.; vt.] to hurry; to rush; to hasten; to make something happen sooner
上下	じょうげ	[n.] top and bottom; high and low; above and below; upper and lower ends; up and down // [n.; suru] going up and down; rising and falling; fluctuating // [n.] going and coming back // [n.] upper and lower classes; ruler and ruled; the government and the people // [n.] first and second volumes
飛行機	ひこうき	[n.] aeroplane; airplane; aircraft
訓練	くんれん	[n.; suru] practice; practising; training
何	なに,なん	[pron.; no-n.] what // [pref.] how many // [n.] you-know-what; that // [phrase] whatsit; what's the expression; what do you call them // [interj.] what? // [n.] hey!
度	ど	[n.; sufn.] degree (angle, temperature, scale, etc.) // [cnt.] counter for occurrences and times // [n.] strength (of alcohol)
何度	なんど	[n.] how many times?; how often?
近く	ちかく	[advn.; n.] near; neighbourhood; neighborhood; vicinity // [sufn.] nearly (e.g. "it took nearly one year"); close to // [adv.] shortly; soon
千葉	ちば	[n.] Chiba (city)
お参り	おまいり	[n.; suru] worship; shrine visit
気持ちよい	きもちよい	[phrase; adj.] good feeling; feeling good
お坊さん	おぼうさん	[n.; fam.; sonkeigo] Buddhist priest; monk // [fam.; sonkeigo] son (of others)
磨く	みがく	[v5ku.; vt.] to polish; to shine; to brush (e.g. teeth) // [n.] to refine; to improve
天井	てんじょう	[n.] ceiling; ceiling price
竹	たけ	[n.] bamboo // [n.] middle (of a three-tier ranking system)
部屋	へや	[n.] room; chamber // [n.] apartment; flat; pad // [abbr.] stable
敷く	しく	[v5ku.] to spread out; to lay out // [n.] to take a position // [n.] to impose widely (e.g. over a city)
枚	まい	[cnt.] counter for flat objects (e.g. sheets of paper)
畳	じょう	[cnt.] counter for tatami mats // [n.] measure of room size (in mat units)
畳	たたみ	[n.] tatami mat; Japanese straw floor coverings
絵文字	えもじ,エモジ	[n.] emoji; pictorial symbol; pictograph
展示	てんじ	[n.; suru] exhibition; display
美術	びじゅつ	[n.; no-n.] art; fine arts
館	かん	[n.; suffix] house; hall; building
電話	でんわ	[n.; suru; no-n.] telephone call; phone call // [n.; no-n.; abbr.] telephone (device); phone
天気	てんき	[n.] weather; the elements // [n.] fair weather; fine weather
晴れ	はれ	[n.; no-n.] clear weather; fine weather // [no-n.; n.] formal; ceremonial; public // [n.] cleared of suspicion
笑う	わらう	[v5u.; vi.] to laugh // [n.] to smile // [n.] to sneer; to ridicule // [n.] to be dumbfounded; to be flabbergasted
絵	え	[n.; sufn.] picture; drawing; painting; sketch
大きい	おおきい	[adj.] big; large; great; loud
大きさ	おおきさ	[n.] size; dimensions; volume
短い	みじかい	[adj.] short
軍	ぐん	[n.] army; force; troops
賭ける	かける	[v1.; vt.] to wager; to bet; to risk; to stake; to gamble
遊ぶ	あそぶ,あすぶ	[v5bu.; vi.] to play; to enjoy oneself; to have a good time // [n.] to mess about (with alcohol, gambling, philandery, etc.) // [n.] to be idle; to do nothing; to be unused // [n.] to go to (for pleasure or for study) // [n.] to intentionally throw a ball to lower the batter's concentration
建てる	たてる	[v1.; vt.] to build; to construct
議員	ぎいん	[n.] member of the Diet, congress or parliament
病気になる	びょうきになる	[phrase; v5ru.] to fall ill; to be taken ill
遅い	おそい	[adj.] slow // [n.] late (e.g. "late at night") // [n.] too late // [arch.] dull; stupid
夜遅く	よるおそく	[adv.] late at night; at a late hour
決まる	きまる	[v5ru.; vi.] to be decided; to be settled // [n.] to look good in (clothes)
弁護士	べんごし	[n.] lawyer; attorney
指	ゆび,および,おゆび	[n.] finger; toe; digit
鍋	なべ	[n.] saucepan; pot // [n.; sufn.] stew; hot pot
男	おとこ,おっこ	[n.; prefn.] man; male // [n.] fellow; guy; chap; bloke // [n.] male lover; boyfriend; man // [n.] manliness; manly honor; manly honour; manly reputation
触る	さわる	[v5ru.; vi.] to touch; to feel
店員	てんいん	[n.; no-n.] shop assistant; employee; clerk; salesperson
怖い	こわい	[adj.] scary; frightening; eerie; dreadful // [interj.] (I'm) afraid
ように言う	ようにいう	[phrase; v5u.] to tell (somebody) to (do something)
母親	ははおや	[n.; no-n.] mother
トンネル		[n.] tunnel // [suru] to tunnel (through a potential barrier) // [n.; suru] letting a grounder go through one's legs
南北	なんぼく	[n.] north and south; north to south // [abbr.] South Korea and North Korea
通る	とおる	[v5ru.; vi.] to go by; to go past; to go along; to travel along; to pass through; to use (a road); to take (a route); to go via; to go by way of // [n.] to run (between); to operate (between); to connect // [n.] to go indoors; to go into a room; to be admitted; to be shown in; to be ushered in; to come in // [n.] to penetrate; to pierce; to skewer; to go through; to come through // [n.] to permeate; to soak into; to spread throughout // [n.] to carry (e.g. of a voice); to reach far // [n.] to be passed on (e.g. of a customer's order to the kitchen); to be relayed; to be conveyed // [n.] to pass (a test, a bill in the House, etc.); to be approved; to be accepted // [n.] to go by (a name); to be known as; to be accepted as; to have a reputation for // [n.] to be coherent; to be logical; to be reasonable; to be comprehensible; to be understandable; to make sense // [n.] to get across (e.g. of one's point); to be understood // [n.] to be straight (e.g. wood grain) // [arch.] to be well-informed; to be wise // [suffix; v5ru.] to do ... completely; to do ... thoroughly
長さ	ながさ	[n.] length
北側	きたがわ,ほくそく	[n.] north side; north bank
中央駅	ちゅうおうえき	[n.] central station
南側	みなみがわ,なんそく	[n.] south side
と考えられる	とかんがえられる	[phrase; v1.] one can think that ...; it is conceivable that ...
教える	おしえる	[v1.; vt.] to teach; to instruct // [n.] to tell; to inform // [n.] to preach
目	め	[n.] eye; eyeball // [n.] eyesight; sight; vision // [n.] look; stare; glance // [n.] an experience // [n.] viewpoint // [n.] stitch; texture; weave // [suffix] ordinal number suffix // [n.] somewhat; -ish
見える	みえる	[v1.; vi.] to be seen; to be in sight // [n.] to look; to seem; to appear // [sonkeigo] to come
目が見える	めがみえる	[phrase; v1.] to be able to see (oft. used in the negative)
転がる	ころがる	[v5ru.; vi.] to roll; to tumble // [n.] to fall over; to roll over // [n.] to lie down // [n.] to be scattered about; to be common // [n.] (of a situation or outcome) to change; to turn out
音	おと,ね,おん	[n.; sufn.] sound; noise; report // [n.] note // [n.] fame // [n.] Chinese-derived character reading
代表	だいひょう	[n.; suru; no-n.] representative; representation; delegation; type; example; model
若い	わかい	[adj.] young; youthful // [n.] immature; green // [n.] low (number); small
声	こえ	[n.] voice
声を出す	こえをだす	[phrase; v5su.] to speak; to say; to vocalize
知らせる	しらせる	[v1.; vt.] to notify; to advise; to inform
初めて	はじめて	[adv.; no-n.] for the first time // [adv.] only after ... is it ...; only when ... do you ...
総理	そうり	[n.; abbr.] prime minister (as the head of a cabinet government); premier // [n.; suru] leading; overseeing; leader; overseer; president
北方領土	ほっぽうりょうど	[n.] the Northern Territories
山口県	やまぐちけん	[n.] Yamaguchi prefecture (Chuugoku area)
旅館	りょかん	[n.] ryokan; Japanese-style lodging, usu. professionally-run
話	はなし	[n.] talk; speech; chat; story; conversation // [n.] discussions; negotiation; argument
話	わ	[cnt.] counter for stories, episodes of TV series, etc.
話をする	はなしをする	[phrase; vsuruirr.] to have a talk; to tell a story
続けて	つづけて	[adv.] successively; continuously; in a row
島	しま	[n.] island // [us. kana] territory (of a prostitute, organized crime gang, etc.); turf
医療	いりょう	[n.; no-n.] medical care; medical treatment
制度	せいど	[n.; no-n.] system; institution; organization; organisation
次	つぎ	[n.; no-n.] next; following; subsequent // [n.] stage; station
大戦	たいせん	[n.] great war; great battle
行く	いく,ゆく	[v5iku.; vi.] to go; to move (in a direction or towards a specific location); to head (towards); to be transported (towards); to reach // [n.] to proceed; to take place // [n.] to pass through; to come and go // [n.] to walk // [n.] to die; to pass away // [n.] to do (in a specific way) // [n.] to stream; to flow // [auxv.] to continue // [v5iku.; vi.; us. kana] to have an orgasm; to come; to cum // [us. kana; slang] to trip; to get high; to have a drug-induced hallucination
自由に	じゆうに	[adv.] freely
できるだけ早く	できるだけはやく	[phrase] as soon as possible
受け付け	うけつけ	[n.] reception (desk); information desk // [n.; suru] receipt; acceptance
郵便	ゆうびん	[n.] mail service; postal service; mail; post // [abbr.] mail; postal matter; postal items
葉書	はがき,ハガキ	[n.; abbr.; us. kana] postcard // [us. kana] memo; note; card
億	おく	[num.] 10^8; 100,000,000; hundred million
少なくなる	すくなくなる	[phrase; v5ru.; vi.] to lessen; to decrease; to diminish
籤	くじ	[n.; us. kana] lottery; lot
買う	かう	[v5u.; vt.] to buy; to purchase // [n.] to value; to have a high opinion // [n.] to stir; to provoke
続く	つづく	[v5ku.; vi.] to continue; to last; to go on // [n.] to continue (without a break); to be unbroken // [n.] to occur again and again // [n.] to lead to; to connect to; to adjoin // [n.] to come after; to follow; to succeed; to rank next to // [n.] to hold out; to keep; to last
続いて	つづいて	[conj.] subsequently; next // [phrase] after ...; following ...; in the wake of ...
激しい	はげしい	[adj.] violent; furious; tempestuous // [n.] extreme; intense; fierce; strong // [n.] fervent; vehement // [n.] incessant; relentless // [arch.] precipitous; steep
死ぬ	しぬ	[v5nu.; vnuirr.; vi.; sensitive] to die; to pass away // [n.] to lose spirit; to lose vigor; to look dead // [n.] to cease; to stop
逃げる	にげる	[v1.; vi.] to escape; to run away
逃がす	にがす	[v5su.; vt.] to miss; to lose; to give away; to let go; to set free; to let get away
外	そと,と	[n.] outside; exterior // [n.] open air // [n.] other place
歴史	れきし	[n.; no-n.] history
勉強	べんきょう	[n.; suru] study // [n.] diligence // [n.] discount; reduction
試験勉強	しけんべんきょう	[n.; suru] studying for a test
高校生	こうこうせい	[n.] senior high school student
大学	だいがく	[n.] post-secondary education institution, incl. university, college, etc. // [abbr.] former central university of Kyoto (established under the ritsuryo system for the training of government administrators) // [n.] the Great Learning (one of the Four Books)
入学	にゅうがく	[n.; suru] entry to school or university; matriculation; enrolment (in university, etc.)
本	ほん	[n.] book; volume; script // [pref.] this; present // [n.] main; head // [n.] real; regular // [suffix; cnt.] counter for long cylindrical things; counter for films, TV shows, etc.; counter for goals, home runs, etc.; counter for telephone calls
売り出す	うりだす	[v5su.; vt.] to put on the market; to put out for sale; to put on sale; to begin selling; to market // [v5su.; vi.] to become popular
売れる	うれる	[v1.; vi.] to sell (well) // [n.] to be well known; to be popular; to be famous
持って行く	もっていく,もってゆく	[phrase; v5iku.] to take; to carry (something) away; to bear
小学生	しょうがくせい	[n.] elementary school student; primary school student; grade school student
中学生	ちゅうがくせい	[n.] junior high school student; middle school pupil
試験を受ける	しけんをうける	[phrase; v1.] to sit for an examination
難しい	むずかしい,むつかしい	[adj.] difficult; hard; troublesome; complicated; serious (disease, problem, etc.) // [n.] fussy; particular; fastidious; hard to please; displeased // [n.] gloomy; glum; sullen; serious (look) // [arch.] dirty; unclean; filthy; detestable // [arch.] unpleasant; uncomfortable; creepy; spooky
言葉	ことば,けとば	[n.] language; dialect // [n.] word; words; phrase; term; expression; remark // [n.] speech; (manner of) speaking
送付	そうふ	[n.; suru] sending (esp. email attachments); forwarding; remitting
御	お,ご	[pref.; sonkeigo; teineigo; kenjougo; us. kana] honorific/polite/humble prefix // [suffix; sonkeigo] honorific suffix
山	やま	[n.; cnt.] mountain; hill // [n.] mine (e.g. coal mine) // [n.] heap; pile // [n.] crown (of a hat); thread (of a screw); tread (of a tire); protruding part of an object // [n.] climax; peak; critical point // [n.] guess; speculation // [n.] criminal case; crime // [n.] mountain climbing; mountaineering // [n.] festival float (esp. one mounted with a decorative halberd) // [n.] wall; wall tile // [arch.] temple; temple grounds // [prefn.] wild
先日	せんじつ	[advn.; tempn.] the other day; a few days ago
不足	ふそく	[adjn..; n.; suru] insufficiency; shortage; deficiency; lack; dearth
申し訳	もうしわけ	[n.; suru] apology; excuse
申し訳ありません	もうしわけありません	[phrase] I'm sorry; (it's) inexcusable // [n.] thank you very much (for help, etc.)
不明	ふめい	[adjn..; n.] unknown; obscure; indistinct; uncertain; ambiguous // [n.] anonymous; unidentified // [n.] ignorant; lack of wisdom
点	てん	[n.; sufn.] spot; mark // [n.] point; dot // [n.] mark (e.g. in exam); score; points // [n.] comma // [n.] aspect; matter; respect // [cnt.] counter for goods, items, articles of clothing, works of art, etc.
気軽	きがる	[adjn..] carefree; buoyant; lighthearted; sprightly // [n.] ease
気軽に	きがるに	[adv.] freely; readily; cheerfully; without any sense of hesitation; without reserve; without treating it as a big deal; casually
今後とも	こんごとも	[advn.] from now on
宜しい	よろしい	[adj.; us. kana; sonkeigo] good; OK; all right; fine; very well; will do; may; can
宜しくお願いします	よろしくおねがいします	[phrase] please remember me; please help me; please treat me well; I look forward to working with you
お願いします	おねがいします	[phrase; kenjougo] please
防衛	ぼうえい	[n.; suru] defense; defence; protection; self-defense; self-defence
省	しょう	[n.; sufn.] ministry; department // [n.] province (of China) // [prefn.] saving; conserving
防衛省	ぼうえいしょう	[n.] Ministry of Defense (formerly Japan Defense Agency)
はっきり	はっきり,ハッキリ	[adv.; to-adv.; ono.] clearly; plainly; distinctly // [suru] to be clear; to be definite; to be certain; to be exact; to become clear; to clear up
区	く	[n.] ward; district; section
掻く	かく	[v5ku.; vt.; us. kana] to scratch // [n.] to perspire // [n.] to shovel; to paddle
画	かく	stroke (of a kanji, etc.)
斯く	かく	[adv.; no-n.; us. kana] like this; such; thus; in this way
斯くて	かくて	[adv.; conj.; us. kana] thus; in this way
配る	くばる	[v5ru.; vt.] to distribute; to deliver; to deal (cards)
薄い	うすい	[adj.] thin // [n.] pale; light // [n.] watery; dilute; sparse // [n.] weak (taste, etc.) // [n.] slim (probability, etc.); small
灰色	はいいろ	[n.; no-n.] grey; gray; ashen
袖	そで	[n.] sleeve // [n.] wing (of a stage, desk, gate, etc.)
紫	むらさき	[n.] purple; violet // [us. kana] Lithospermum erythrorhizon (species of gromwell) // [n.] type of soy sauce
服	ふく	[n.; sufn.] clothes (esp. Western clothes) // [suffix; cnt.] counter for doses of medicine, gulps of tea, drags of a cigarette, etc.
小さな	ちいさな	[pren.] small; little; tiny
署	しょ	[n.; abbr.] station (esp. a police station); office (i.e. tax office)
警察署	けいさつしょ	[n.] police station
番号	ばんごう	[n.] number; series of digits
本当	ほんとう,ほんと,ホント,ホントー,ホントウ	[no-n.; adjn..; adv.; n.] truth; reality; actuality; fact // [no-n.; adjn..; adv.] proper; right; correct; official // [n.] genuine; authentic; natural; veritable
選挙	せんきょ	[n.; suru; no-n.] election
候補	こうほ	[n.] candidate; contender; prospect; pick; choice; list // [n.] candidacy; candidature; nomination
専門	せんもん	[n.; no-n.] speciality; specialty; subject of study; expert; area of expertise
付ける	つける	[v1.; vt.] to attach; to join; to add; to append; to affix; to stick; to glue; to fasten; to sew on; to apply (ointment) // [n.] to furnish (a house with) // [n.] to wear; to put on // [n.] to keep a diary; to make an entry // [n.] to appraise; to set (a price) // [n.] to allot; to budget; to assign // [n.] to bring alongside // [n.] to place (under guard or doctor) // [n.] to follow; to shadow // [n.] to load; to give (courage to) // [n.] to keep (an eye on) // [n.] to establish (relations or understanding) // [n.] to turn on (light) // [n.] to produce flowers; to produce fruit
毎日	まいにち	[advn.; tempn.] every day
午前	ごぜん	[advn.; tempn.] morning; a.m.
給料	きゅうりょう	[n.] salary; wages
過ごす	すごす	[v5su.; vt.] to pass (time); to spend // [n.] to overdo (esp. of one's alcohol consumption); to drink (alcohol) // [arch.] to take care of; to support // [suffix; v5su.] to overdo; to do too much // [n.] to ... without acting on it
奈良	なら	[n.] Nara (city)
南瓜	かぼちゃ,ぼうぶら,なんか,カボチャ	[n.; us. kana] pumpkin (Cucurbita sp.); squash
冬至	とうじ	[n.; no-n.] winter solstice
近い	ちかい	[adj.] near; close; short (distance)
日曜日	にちようび	[advn.; tempn.] Sunday
杯	はい,はた	[n.] sake cup; cup for alcoholic beverages // [suffix; cnt.] counter for cupfuls // [n.] counter for ships, octopuses and squid
早くから	はやくから	[phrase] early on; earlier on; from early
便利	べんり	[adjn..] convenient; handy; useful
外国	がいこく,そとぐに	[n.; no-n.] foreign country
自動車	じどうしゃ	[n.] automobile
高さ	たかさ	[n.] height; altitude; elevation; level
春	はる	[advn.; tempn.] spring; springtime // [n.] New Year // [n.] prime (of one's life, etc.) // [n.] adolescence; puberty // [n.] sexuality
低い	ひくい	[adj.] low (rank, degree, value, content, quality, etc.) // [n.] low (position); close to the ground // [n.] short (height) // [n.] deep (voice); in a low key; low (volume)
降りる	おりる	[v1.; vi.] to descend (e.g. a mountain); to go down; to come down // [n.] to alight (e.g. from bus); to get off; to disembark; to dismount // [n.] to step down; to retire; to give up; to quit // [n.] to be granted; to be issued; to be given // [n.] to form (of frost, dew, mist, etc.) // [n.] to be passed (from the body; e.g. of a roundworm)
日産	にっさん	[n.] daily output // [abbr.] Nissan (Japanese car company)
去年	きょねん,こぞ	[advn.; tempn.] last year
横に	よこに	[adv.] horizontally; flat // [n.] across; crossways; crosswise; sideways; abreast
広島	ひろしま,ヒロシマ	[n.] Hiroshima (city) // [n.] atomic bombing of Hiroshima
お礼	おれい,おんれい	[n.; teineigo] thanks; gratitude // [teineigo] manners; etiquette // [teineigo] bow // [teineigo] reward; gift // [teineigo] ceremony; ritual
手紙	てがみ	[n.; no-n.] letter
大使館	たいしかん	[n.] embassy
喜んで	よろこんで	[adv.] with pleasure ...
今月	こんげつ	[advn.; tempn.] this month
明るい	あかるい	[adj.] bright; colourful // [n.] cheerful // [n.] familiar (with); knowledgeable (about) // [n.] fair (e.g. politics); clean
頑張る	がんばる	[v5ru.; vi.] to persevere; to persist; to keep at it; to hang on; to hold out; to do one's best // [n.] to insist that; to stick to (one's opinion) // [n.] to remain in a place; to stick to one's post; to refuse to budge
頑張って	がんばって	[phrase] do your best; go for it; hold on; keep at it
走り続ける	はしりつづける	[v1.] to keep running
昼	ひる	[advn.; tempn.] noon; midday // [n.] daytime // [n.] lunch
運	うん	[n.] fortune; luck
転	てん	[n.] altering pronunciation or meaning; word with altered pronunciation or meaning // [abbr.] turning or twisting part of a text (in Chinese poetry)
転	くるり	[adv.; to-adv.; us. kana; ono.] turning around (once) // [n.] suddenly; abruptly // [n.] completely (wrapped in something); quickly (unwrapping something) // [n.] beautiful, round (eyes) // [n.; abbr.] flail (for threshing grain)
テレビ局	テレビきょく	[n.] television station
映画	えいが	[n.; no-n.] movie; film
名	な	[n.] name; given name // [n.] title // [n.] fame; renown; reputation // [n.] pretext; pretense; justification; appearance
上映	じょうえい	[n.] screening (a movie); showing // [suru] to screen a movie
円	えん	[n.] yen; Japanese monetary unit // [n.] circle
週間	しゅうかん	[cnt.] weeks (period of)
空間	くうかん	[n.] space; room; airspace
宇宙空間	うちゅうくうかん	[n.; no-n.] outer space; void of space
観測	かんそく	[n.; suru] observation; survey; measurement
観測所	かんそくじょ	[n.] observatory; observation post
故障	こしょう	[n.; suru] breakdown; failure; fault; accident; out of order // [n.] damage; hurt // [n.] objection; protest
外国人	がいこくじん	[n.] foreigner; foreign citizen; foreign national; alien; non-Japanese
国土	こくど,くにつち	[n.] country; territory; domain; realm
国土交通省	こくどこうつうしょう	[n.] Ministry of Land, Infrastructure, Transport and Tourism
安い	やすい	[adj.] cheap; inexpensive // [n.] calm; peaceful; quiet
戦士	せんし	[n.] soldier; combatant; warrior
通信	つうしん	[n.; suru] correspondence; communication; transmission; news; signal; telecommunications
社	やしろ	[n.] shrine (usually Shinto)
社	しゃ	[n.; sufn.; abbr.] company; association; society // [n.] regional Chinese god of the earth (or a village built in its honour) // [cnt.; suffix] counter for companies, shrines, etc.
通信社	つうしんしゃ	[n.] news agency
大分	だいぶ,だいぶん	[adv.; us. kana] considerably; greatly; a lot
お菓子	おかし	[n.] confections; sweets; candy
雪	ゆき	[n.] snow
車	くるま	[n.] car; automobile; vehicle // [n.] wheel
先	さき	[n.; no-n.; sufn.; pref.] previous; prior; former; first; earlier; some time ago; preceding // [n.] point (e.g. pencil); tip; end; nozzle // [n.] head (of a line); front // [n.] ahead; the other side // [n.] the future; hereafter // [n.] destination // [n.] the other party
先月	せんげつ	[advn.; tempn.] last month
始めて	はじめて	[adv.; no-n.] for the first time // [adv.] only after ... is it ...; only when ... do you ...
投げる	なげる	[v1.; vt.] to throw; to cast away // [n.] to face defeat; to give up
次に	つぎに	[conj.] next; then; after that
急に	きゅうに	[adv.] swiftly; rapidly // [n.] suddenly; abruptly; immediately
税金	ぜいきん	[n.] tax; duty
銀行	ぎんこう	[n.; no-n.] bank
急いで	いそいで	[phrase] hurriedly
困る	こまる	[v5ru.; vi.] to be troubled; to be worried; to be bothered; to be embarrassed; to be stumped
滑走	かっそう	[n.; suru] gliding; sliding; skating (on ice); glide; slide // [n.] taxiing (aircraft); making a takeoff run
着物	きもの	[n.] clothing; clothes // [n.] kimono (or other trad. Japanese clothing)
互い	たがい	[n.] mutual; reciprocal
弱い	よわい	[adj.] weak; frail; delicate; tender; unskilled; weak (wine)
弱くする	よわくする	[phrase; vsuruirr.] to turn down (heat, sound, etc.)
星	ほし	[n.] star; any light-emitting (or reflecting) heavenly body (except for the sun and the moon) // [slang] offender; perpetrator // [n.] star point (in go); hoshi; intersection marked with a dot // [n.] circular symbol (said to be shaped like a shining star) // [n.] bullseye // [n.] one's star (out of the nine stars); the star that determines one's fate // [n.] small dot; spot // [n.] point; score
察し	さっし	[n.] consideration; guess; conjecture; judgment; judgement
引く	ひく	[v5ku.; vi.; vt.] to pull // [n.] to draw (attention, etc.); to attract (interest, etc.) // [n.] to draw back // [n.] to draw (a card) // [n.] to draw (plan, line, etc.) // [n.] to catch (cold) // [n.] to play (string instr.) // [n.] to look up (e.g. dictionary); to consult // [v5ku.; vt.] to haul; to pull (vehicles) // [n.] to subtract // [n.] to ebb; to fade // [n.] to descend (from); to inherit (a characteristic) // [n.] to quote; to raise (as evidence) // [n.] to lay (a cable); to draw (a cable)
方	かた	[n.] direction; way // [sonkeigo] person; lady; gentleman // [n.; sufn.] method of; manner of; way of // [sufn.] care of .. // [n.] person in charge of .. // [n.] side (e.g. "on my mother's side")
者	もの,もん	[n.] person
上げる	あげる	[v1.; vt.] to raise; to elevate // [n.] to do up (one's hair) // [n.] to fly (a kite, etc.); to launch (fireworks, etc.); to surface (a submarine, etc.) // [n.] to land (a boat) // [n.] to deep-fry // [n.] to show someone (into a room) // [us. kana] to summon (for geishas, etc.) // [n.] to send someone (away) // [n.] to enrol (one's child in school); to enroll // [n.] to increase (price, quality, status, etc.); to develop (talent, skill); to improve // [n.] to make (a loud sound); to raise (one's voice) // [n.] to earn (something desirable) // [n.] to praise // [n.] to give (an example, etc.); to cite // [n.] to summon up (all of one's energy, etc.) // [n.] to arrest // [n.] to nominate // [teineigo] to give // [n.] to offer up (incense, a prayer, etc.) to the gods (or Buddha, etc.) // [n.] to bear (a child) // [n.] to conduct (a ceremony, esp. a wedding) // [v1.; vi.] (of the tide) to come in // [v1.; vi.; vt.] to vomit // [auxv.; v1.; us. kana; teineigo] to do for (the sake of someone else) // [n.] to complete ... // [kenjougo] to humbly do ...
南	みなみ	[n.] south
西	にし	[n.] west
北	きた	[n.] north // [n.] the North; northern territories // [abbr.] North Korea // [arch.] north wind
食品	しょくひん	[n.] food; food products; foodstuffs
切れる	きれる	[v1.; vi.] to break; to snap; to be cut; to split; to crack // [n.] to be injured // [n.] to wear out; to be worn out // [n.] to break; to burst; to collapse // [n.] to wear off; to stop working; to go dead // [n.] to expire (time limit, etc.); to run out; to become due // [n.] to run out (of stock, etc.); to be exhausted; to be used up; to be sold out; to be out of // [n.] to be broken off (e.g. of a relationship); to break up; to have severed ties; to be cut off; to be disconnected // [n.] to cut well; to be sharp // [n.] to be sharp-minded; to be keen; to be shrewd; to be quick-witted; to be able // [n.] to be short of; to drop under (a certain figure); to beat (e.g. a record time) // [n.] to dry off // [n.] to curve; to veer // [n.] to shuffle (cards) // [coll.] to get angry; to snap; to blow one's top; to lose one's temper; to flip // [auxv.; v1.; us. kana] to be able to do completely
期限が切れる	きげんがきれる	[phrase; v1.] to have a time-limit expire; to pass a deadline; to pass an expiration date
過ぎる	すぎる	[v1.; vi.] to pass through; to pass by; to go beyond // [n.] to pass (i.e. of time); to elapse // [n.] to have expired; to have ended; to be over // [n.] to exceed; to surpass; to be above // [n.] to be no more than ... // [v1.; vi.; suffix; us. kana] to be excessive; to be too much; to be too ...
過ぎる	よぎる	[v5ru.; us. kana] to go by; to cross; to pass by; to float across
米	こめ,よね,めめ,コメ	[n.] (husked grains of) rice // [n.] 88 years old
原子力発電	げんしりょくはつでん	[n.] nuclear power generation; nuclear electricity generation
牛肉	ぎゅうにく	[n.] beef
地方	ちほう	[n.; no-n.] district; region; area; locality // [n.] the country; countryside; the provinces; rural area
年度	ねんど	[n.; sufn.] fiscal year (usu. April 1 to March 31 in Japan); financial year // [n.] academic year; school year // [n.] product year
計画を進める	けいかくをすすめる	[phrase; v1.] to carry a plan forward
雷	かみなり,いかずち,いかづち,らい	[n.] lightning; thunder; thunderbolt // [n.] god of thunder; god of lightning // [n.] anger; fit of anger
雷が落ちる	かみなりがおちる	[phrase; v1.] to be struck by lightning // [n.] to be yelled at (by someone of higher status); to be scolded harshly
雲	くも	[n.] cloud
土地	とち,どおじ,どじ,どち	[n.] plot of land; lot; soil // [n.] locality; region; place
返す	かえす	[v5su.; vt.] to return (something); to restore; to put back // [n.] to turn over; to turn upside down; to overturn // [n.] to pay back; to retaliate; to reciprocate // [suffix; v5su.] to repeat ...; to do ... back
北部	ほくぶ	[n.; no-n.] northern part; the north (of a region)
物	もの,もん	[n.] thing; object; article; stuff; substance // [n.] one's things; possessions; property; belongings // [n.] things; something; anything; everything; nothing // [n.] quality // [n.] reason; the way of things // [us. kana] used to emphasize emotion, judgment, etc.; used to indicate a common occurrence in the past (after a verb in past tense); used to indicate a general tendency; used to indicate something that should happen // [sufn.] item classified as ...; item related to ...; work of ... // [n.] cause of ...; cause for ... // [pref.] somehow; somewhat; for some reason // [n.] really; truly
持ち主	もちぬし	[n.] owner; proprietor; possessor (e.g. of talent, beauty, etc.)
公園	こうえん	[n.] (public) park
国立公園	こくりつこうえん	[n.] national park
世界自然遺産	せかいしぜんいさん	[n.] world natural heritage site
自然遺産	しぜんいさん	[n.] natural heritage; natural heritage site
お腹	おなか	[n.; teineigo] stomach
何度も	なんども	[adv.] many times over; often
下痢	げり	[n.; suru; no-n.] diarrhoea; diarrhea
遺伝子	いでんし	[n.] gene // [n./prenv.; no-n.] genetic
洗う	あらう	[v5u.; vt.] to wash // [n.] to investigate
手袋	てぶくろ	[n.] glove; mitten; mitt
暗号	あんごう	[n.; no-n.] code; password; cipher
欄	らん	[n.; sufn.] column of text (e.g. in a newspaper) // [n.] field (in a form, web page, etc.)
コメント欄	コメントらん	[n.] comment field (e.g. on a blog)
宛	あて	[n.] aim; object; purpose; end // [n.] expectations; prospects; hopes // [n.] something that can be relied upon // [n.] snack served with alcoholic drink // [sufn.] pad; guard // [sufn.; prefn.] blow; strike // [suffix] addressed to // [us. kana] per
添付	てんぷ	[n.; suru; no-n.] attachment (e.g. email); appendix (e.g. of a report, document, etc); annex; appendage; annexure
食う	くう	[v5u.; vt.; male] to eat // [n.] to live; to make a living; to survive // [n.] to bite; to sting (as insects do) // [n.] to tease; to torment; to taunt; to make light of; to make fun of // [n.] to encroach on; to eat into; to consume // [n.] to defeat a superior; to threaten a position // [n.] to consume time and-or resources // [coll.] to receive something (usu. an unfavourable event) // [male; vulg.] to have sexual relations with a woman, esp. for the first time
意味	いみ	[n.; suru] meaning; significance
応答	おうとう	[n.; suru] reply; answer; response
不具合	ふぐあい	[n.; adjn..] flaw; defect; problem; bug; malfunction; failure; discrepancy // [adjn..] inconvenient
騙す	だます	[v5su.; vt.] to trick; to cheat; to deceive // [n.] to coax; to wheedle; to soothe and humor (humour)
騙し騙し	だましだまし	[n.; suru] using every trick (in the book)
到頭	とうとう	[adv.; us. kana] finally; at last; ultimately; in the end
鼕々	とうとう	[taru adj.; to-adv.; us. kana] sound of bells or drums reverberating // [us. kana] sound of water or waves resounding
多分	たぶん	[adv.] perhaps; probably // [adjn..; no-n.] generous; many; much; great
差し替える	さしかえる	[v1.; vt.] to change; to replace
覚える	おぼえる	[v1.; vt.] to memorize; to memorise; to commit to memory; to learn by heart; to bear in mind; to remember // [n.] to learn; to pick up; to acquire // [n.] to feel // [n.] to think; to regard
面倒くさい	めんどくさい,めんどうくさい	[adj.; us. kana] bothersome; tiresome; bother to do
仕方	しかた	[n.] way; method; means; resource; course
開ける	あける	[v1.; vt.] to open (a door, etc.); to unwrap (e.g. parcel, package); to unlock // [n.] to open (for business, etc.) // [n.] to empty; to remove; to make space; to make room // [n.] to move out; to clear out // [n.] to be away from (e.g. one's house); to leave (temporarily) // [v1.; vi.] to dawn; to grow light // [n.] to end (of a period, season) // [n.] to begin (of the New Year) // [n.] to leave (one's schedule) open; to make time (for) // [n.] to make (a hole); to open up (a hole)
無関心	むかんしん	[adjn..; n.] apathetic; indifferent
昨日	きのう,さくじつ	[advn.; tempn.] yesterday
寝る	ねる	[v1.; vi.] to lie down // [n.] to go to bed; to lie in bed // [n.] to sleep (lying down) // [n.] to sleep (with someone, i.e. have intercourse) // [n.] to lie idle
今朝	けさ,こんちょう	[tempn.] this morning
寒気	さむけ,かんき	[n.] chill; the shivers; shivering fit // [n.] cold; coldness; cold air
飲む	のむ	[v5mu.; vt.] to drink; to gulp; to swallow; to take (medicine) // [n.] to smoke (tobacco) // [n.] to engulf; to overwhelm // [n.] to keep down; to suppress // [n.] to accept (e.g. demand, condition) // [n.] to make light of; to conceal
寝入る	ねいる	[v5ru.; vi.] to fall asleep
一寝入り	ひとねいり	[n.; suru] nap
良い	よい	[adj.; us. kana] good; excellent; fine; nice; pleasant; agreeable // [n.] sufficient (can be used to turn down an offer); ready; prepared // [n.] profitable (e.g. deal, business offer, etc.); beneficial // [n.] OK
疲れ	つかれ	[n.] tiredness; fatigue
溜まる	たまる	[v5ru.; vi.; us. kana] to collect; to gather; to save; to accumulate; to pile up
公休	こうきゅう	[n.] legal holiday
脈絡	みゃくらく	[n.] chain of reasoning; logical connection; coherence; context
夕方	ゆうがた	[advn.; tempn.] evening; dusk
空	そら	[n.] sky; the air; the heavens // [n.] weather // [n.] far-off place; distant place // [n.] state of mind; feeling // [n.] (from) memory; (by) heart // [n.] falsehood; lie // [prefn.] somehow; vaguely // [n.] fake
津波	つなみ	[n.] tsunami; tidal wave
思わず	おもわず	[adv.] unintentionally; reflexively; spontaneously; involuntarily; instinctively
今回	こんかい	[advn.; tempn.] now; this time; lately
駐車	ちゅうしゃ	[n.; suru; no-n.] parking (e.g. car)
駐車場	ちゅうしゃじょう	[n.] parking lot; parking place
両隣	りょうどなり	[n.] both sides
小っちゃい	ちっちゃい	[adj.; us. kana] tiny; little; wee
仕事中	しごとちゅう	[n.] at work; in the midst of work; working
最終	さいしゅう	[n.; no-n.] last; final; closing
最終日	さいしゅうび	[n.] last day; final day
風	かぜ	[n.] wind; breeze; draught; draft // [n.; prefn.] manner; behaviour; behavior // [n.] cold; influenza
風	ふう	[adjn..; n.; sufn.] method; manner; way; style // [n.] appearance; air // [n.] tendency // [n.] folk song (genre of the Shi Jing) // [n.] wind (one of the five elements)
楽しい	たのしい	[adj.] enjoyable; fun
帰還	きかん	[n.; suru] repatriation; return // [n.] (electrical) feedback
明日	あした,あす,みょうにち	[tempn.] tomorrow // [n.] near future
冷える	ひえる	[v1.; vi.] to grow cold (from room temperature, e.g. in refrigerator); to get chilly; to cool down
不参加	ふさんか	[n.] abstention; nonparticipation
てんこ盛り	てんこもり	[n.; no-n.] heap; pile; stack; spoonful; bowlful
当日	とうじつ	[advn.; tempn.] appointed day; very day
晴れる	はれる	[v1.; vi.] to clear up; to clear away; to be sunny; to stop raining // [n.] to refresh (e.g. spirits) // [n.] to be cleared (e.g. of a suspicion) // [n.] to be dispelled; to be banished
今度	こんど	[advn.; tempn.] now; this time; next time; another time
一応	いちおう	[adv.] more or less; though not quite satisfactorily; after a fashion; pretty much; roughly; so far as it goes // [n.] tentatively; for the time being // [n.] just in case // [n.] once
出かける	でかける	[v1.; vi.] to go out (e.g. on an excursion or outing); to leave; to depart; to start; to set out // [n.] to be about to leave; to be just going out
門	もん,かど	[n.; sufn.] gate // [n.] branch of learning based on the teachings of a single master // [n.] division; phylum // [cnt.] counter for cannons
あしらう	あしらう	[v5u.; vt.] to arrange; to treat; to handle; to deal with
女王	じょおう	[n.; no-n.] queen
忙しい	いそがしい,せわしい	[adj.] busy; hectic; occupied; engaged
王室	おうしつ	[n.] royal family
仕事をやめる	しごとをやめる	[phrase; v1.] to quit one's job; to resign
多すぎる	おおすぎる	[v1.] to be too numerous; to be too much
暑い	あつい	[adj.] hot (weather, etc.); warm
夏	なつ	[advn.; tempn.] summer
秋	あき	[tempn.] autumn; fall
警官	けいかん	[n.] police officer; policeman; constable
撃つ	うつ	[v5tsu.] to shoot (at) // [n.] to attack; to defeat; to destroy; to avenge
撃たれる	うたれる	[v1.; vi.] to be struck; to be beaten
質問	しつもん	[n.; suru; no-n.] question; inquiry; enquiry
質問をする	しつもんをする	[phrase; vsuruirr.] to ask a question; to ask questions
銃	じゅう	[n.] gun; rifle; small arms
認める	みとめる	[v1.; vt.] to recognize; to recognise; to observe; to notice // [n.] to deem; to judge; to assess // [n.] to approve; to deem acceptable; to allow // [n.] to admit; to accept; to confess (to a charge) // [n.] to watch steadily; to observe carefully // [n.] to renown; to give renown to; to appreciate; to acknowledge
火	ひ	[n.; sufn.] fire; flame; blaze
少し	すこし	[adv.; n.] small quantity; little; few; something // [n.] little while // [n.] short distance
広い	ひろい	[adj.] spacious; vast; wide
視力	しりょく	[n.; no-n.] eyesight
文部	もんぶ	[n.; abbr.] Ministry of Education, Culture, Sports, Science and Technology
学校	がっこう	[n.] school
黒板	こくばん	[n.] blackboard
眼鏡	めがね,がんきょう,メガネ	[n.] spectacles; glasses // [n.] judgement; discrimination; discernment; insight
休む	やすむ	[v5mu.; vi.] to be absent; to take a day off // [n.] to rest; to have a break // [n.] to go to bed; to (lie down to) sleep; to turn in; to retire // [n.] to stop doing some ongoing activity for a time; to suspend business
返事	へんじ	[n.; suru] reply; answer; response
税	ぜい	[n.; suffix] tax
消費税	しょうひぜい	[n.] consumption tax (incl. sales tax, VAT, excise duty, etc.)
重い	おもい	[adj.] heavy; weighty; massive // [n.] heavy (feeling); depressed; gloomy; blue; uneasy // [n.] slow; sluggish; lumbering; ponderous; clumsy // [n.] important; serious; grave // [n.] serious; severe; critical // [n.] solid; established; dignified; sensible
重さ	おもさ	[n.] weight
漁師	りょうし	[n.; no-n.; sensitive] fisherman
お酒	おさけ,ごしゅ	[n.; teineigo] alcohol; sake
鳥居	とりい	[n.] torii; Shinto shrine archway
似る	にる	[v1.; vi.] to resemble; to look like; to take after // [n.] to be similar (in status, condition, etc.); to be close; to be alike; to be like
鯨	くじら,クジラ	[n.; us. kana] whale (Cetacea spp.)
盛ん	さかん	[adjn..] popular // [n.] prosperous // [n.] enthusiastic // [n.] energetic; vigorous
燃料	ねんりょう	[n.] fuel
空港	くうこう	[n.] airport
決まり	きまり	[n.; no-n.] rule; regulation // [n.] settlement; conclusion; end; agreement; arrangement // [n.] habit; custom; habitual way // [n.] countenance in front of another person; face // [arch.] love relationship between a customer and a prostitute
往復葉書	おうふくはがき	[n.] postcard with a reply card attached
漁師	りょうし	[n.; no-n.; sensitive] fisherman
毛ガニ	けガニ,けがに	[n.] hair crab (Erimacrus isenbeckii)
蟹	かに,カニ	[n.; us. kana] crab
港	みなと	[n.] harbour; harbor; port
港	こう	[suffix] harbour
取ってくる	とってくる	[vkuru.] to fetch; to go and get
分ける	わける	[v1.; vt.] to divide (into); to split (into); to part; to separate; to divide up; to classify; to sort out; to divide out // [n.] to share; to distribute; to deal out; to dish out // [n.] to distinguish; to discriminate; to differentiate (between) // [n.] to break up (a fight); to mediate // [n.] to call a draw; to tie // [n.] to push one's way through (a crowd) // [n.] to sell
甲羅	こうら	[n.] shell; carapace // [n.] person's back // [n.] years of experience
競り	せり	[n.] competing; competition // [n.] auction
漁協	ぎょきょう	[n.; abbr.] fishery cooperative
災害	さいがい	[n.] calamity; disaster; misfortune
避難	ひなん	[n.; suru] taking refuge; finding shelter; evacuation; escape
台風	たいふう	[n.] typhoon; hurricane
水	みず,み	[n.] water (esp. cool, fresh water, e.g. drinking water) // [n.] fluid (esp. in an animal tissue); liquid // [n.] flood; floodwaters // [n.] water offered to wrestlers just prior to a bout // [n.] break granted to wrestlers engaged in a prolonged bout
高齢	こうれい	[n.; no-n.] advanced (old) age
高齢者	こうれいしゃ	[n.] old person; old people
等	とう	[n.; sufn.; cnt.] class; order; rank // [suffix] et cetera; etc.; and the like // [pref.] equal; iso-
開始	かいし	[n.; suru] start; commencement; beginning; initiation
姫	ひめ	[n.] princess; young lady of noble birth // [sufn.; n.] girl // [pref.] small; cute; lesser (in names of species) // [n.; arch.] prostitute
俳優	はいゆう	[n.; no-n.] actor; actress; player; performer
演じる	えんじる	[v1.; vt.] to perform (a play); to play (a part); to act (a part); to commit (a blunder)
頭がいい	あたまがいい	[phrase; yoi-adj.] bright; intelligent
上手	じょうず,じょうて,じょうしゅ	[adjn..; n.] skill; skillful; dexterity // [n.] flattery
上手	うわて,かみて	[adjn..; n.] upper part // [n.] upper stream; upper course of a river // [n.] right side of the stage (audience's or camera's POV); stage left (actor's POV) // [adjn..; n.] skillful (only in comparisons); dexterity (only in comparisons) // [n.] over-arm grip on opponent's belt
決して	けっして,けして	[adv.] never; by no means; not in the least; in no way
日朝	にっちょう	[n.] Japan and (North) Korea // [no-n.] Japanese-North Korean
会う	あう	[v5u.; vi.] to meet; to encounter; to see // [us. kana] to have an accident; to have a bad experience
船	ふね	[n.] ship; boat; watercraft; vessel; steamship // [n.] tank; tub; vat; trough // [sufn.; cnt.] counter for boat-shaped containers (e.g. of sashimi)
沈む	しずむ	[v5mu.; vi.] to sink; to go under; to submerge // [n.] to go down (e.g. sun); to set; to descend // [n.] to feel depressed
市場	いちば	n. (town) market; n. (the) marketplace
侵犯	しんぱん	[n.; suru] violation; invasion; infringement; trespass
目をやる	めをやる	[phrase; v5ru.] to look towards
領土	りょうど	[n.; no-n.] dominion; territory; possession
天然	てんねん	[n.; no-n.] nature; spontaneity // [abbr.; coll.] natural airhead
悪気	わるぎ	[n.] ill will; malice; evil intent; ill feeling; distrust
若しか	もしか	[adv.; us. kana] if; in case
若しかすると	もしかすると	[phrase; adv.; us. kana] perhaps; maybe; by some chance
装う	よそおう	[v5u.; vt.] to dress // [n.] to pretend; to feign
僧徒	そうと	[n.] priests; monks
態と	わざと	[adv.; us. kana] on purpose
全巻	ぜんかん	[n.] the whole reel; the whole volume; the complete set
通す	とおす	[v5su.; vt.] to stick through; to force through // [n.] to spread throughout; to thoroughly diffuse // [n.] to make a path between two points // [n.] to proceed in a logical manner // [n.] to let pass; to allow through // [n.] to lead (someone) into (a house, room, etc.); to show in // [n.] to go through (a middleman) // [n.] to (look, listen) through (a window, wall, etc.) // [n.] to pass (a law, applicant, etc.) // [n.] to force to accept; to force agreement // [n.] to continue (in a state); to persist in // [n.] to do to the entirety of; to cover all of; to span the whole ... // [n.] to do from beginning to end without a break // [n.] to convey (one's ideas, etc.) to the other party // [n.] to do to the end; to carry through; to complete
通し	とおし	[n.] direct; right through; straight // [n.] appetizer; appetiser // [abbr.] performance of an entire play
崖	がけ	[n.] cliff
崖下	がいか,がけした	[n.] below a cliff
転落	てんらく	[n.; suru] fall; tumble; spill; plunge; dive // [n.] degradation; comedown; demotion; slump
先代	せんだい	[n.] family predecessor; previous age; previous generation
関わる	かかわる	[v5ru.; vi.] to be affected; to be influenced // [n.] to be concerned with; to have to do with // [n.] to stick to (opinions)
拘らず	かかわらず	[phrase; us. kana] in spite of; regardless of
爆睡	ばくすい	[n.; suru; no-n.; coll.] sleeping like a log; (being) fast asleep (bombed, crashed)
脅かす	おどかす	[v5su.; vt.] to threaten; to menace // [n.] to startle; to surprise
脅かす	おびやかす	[v5su.; vt.] to intimidate; to scare // [n.] to jeopardize; to endanger; to imperil
出勤	しゅっきん	[n.; suru] attendance (at work); being at work; presence (in the office); going to work; reporting for work
視線	しせん	[n.] one's line of sight; one's gaze; one's eyes (looking); glance; gaze; look
痛い	いたい	[adj.] painful; sore // [adj.; suffix] exceeding
眠る	ねむる,ねぶる	[v5ru.; vi.] to sleep (not necessarily lying down) // [n.] to die // [n.] to lie idle (e.g. of resources); to be dormant; to be unused // [arch.] to close one's eyes
年男	としおとこ	[n.] Man of the Year, referring to a man born in a year with the same Chinese zodiac sign as the current year
刺す	さす	[v5su.; vt.] to pierce; to stab; to prick; to stick; to thrust // [n.] to sting; to bite // [n.] to sew; to stitch; to embroider // [n.] to pole (a boat) // [n.] to catch (with a limed pole) // [n.] to put (a runner) out; to pick off
やまゆり	やまゆり,ヤマユリ	[n.; us. kana] golden-rayed lily (Lilium auratum)
園	その,えん	[n.; sufn.] garden (esp. man-made); orchard; park; plantation // [n.] place; location
知能	ちのう	[n.] intelligence; intellect; brains
埼玉	さいたま	[n.] Saitama (city)
埼玉県	さいたまけん	[n.] Saitama prefecture (Kanto area)
北朝鮮	きたちょうせん	[n.] North Korea
厳しい	きびしい,いかめしい	[adj.] severe; strict; rigid; unsparing; relentless // [n.] stern; austere; grave; solemn; majestic // [n.] intense (cold); harsh
制裁	せいさい	[n.; suru] restraint; sanctions; punishment
水爆	すいばく	[n.; no-n.; abbr.] hydrogen bomb
理事	りじ	[n.] director; board of directors
安全保障理事会	あんぜんほしょうりじかい	[n.] (UN) Security Council
理事会	りじかい	[n.] board of directors or trustees
考え方	かんがえかた	[n.] way of thinking
発射	はっしゃ	[n.; suru] firing; shooting; discharge; catapult // [slang] ejaculation
決まって	きまって	[phrase] always; without fail; invariably; usually; regularly
共和党	きょうわとう	[n.] Republican Party
民主党	みんしゅとう	[n.] Democratic Party (esp. DPJ or US Democratic Party)
貿易	ぼうえき	[n.; suru] trade (foreign)
協定	きょうてい	[n.; suru] arrangement; pact; agreement
本当に	ほんとうに,ほんとに,ホントに,ホントーに,ホントウに	[adv.] really; truly
号	ごう	[n.; sufn.] number; edition; make; model; issue; part of that group // [n.] sobriquet; pen-name
行方	ゆくえ	[n.] (one's) whereabouts // [n.] outcome
行方不明	ゆくえふめい	[n.; no-n.; yojijukugo] missing; unaccounted for
橋	はし	[n.] bridge
畑	はたけ,はた	[n.] field (for fruits, vegetables, etc.); cultivated land; vegetable plot; kitchen garden; plantation // [n.; suffix] field (of specialization); sphere; area // [coll.] womb; birth; birthplace
あふれる		[v1.; vi.; us. kana] to overflow; to brim over; to flood
全員	ぜんいん	[advn.; n.] all members (unanimity); all hands; the whole crew; everyone; everybody
仮設	かせつ	[n.; no-n.] temporary; provisional // [suru] to do something temporarily (esp. build temporary facilities); to do something provisionally
住宅	じゅうたく	[n.] residence; housing; residential building
仮設住宅	かせつじゅうたく	[n.] temporary dwelling; temporary housing
避難所	ひなんじょ	[n.] place of refuge; shelter
熊本県	くまもとけん	[n.] Kumamoto prefecture (Kyushu)
揺れ	ゆれ	[n.] shaking; shake; jolt; jolting; vibration; tremor; flickering // [n.] unsettledness; instability; vacillating; wavering // [n.] existence of multiple spellings, pronunciations, usages, etc. for a single word
東日本	ひがしにほん,ひがしにっぽん	[n.] eastern Japan; Japan east of the Itoigawa-Shizuoka Tectonic Line, i.e. east of the Chubu region
隣	となり	[n.; no-n.] neighbor (neighbour); next to (esp. living next door to)
暫く	しばらく,しゅゆ,すゆ	[adv.; no-n.; us. kana] little while; short while; moment; instant // [us. kana] a while; quite a time // [interj.; us. kana] it's been a long time
田んぼ	たんぼ,でんぽ	[n.] paddy field; farm
罅	ひび,あかぎれ	[n.; no-n.; us. kana] crack; fissure // [n.; us. kana] rift; split // [n.] chaps; skin fissure
ひびが入る	ひびがはいる	[phrase; v5ru.] to get cracked; to develop a crack; to be fissured
