もちろん	もちろん	Definitely!	
購入	こうにゅう	purchase	
素麺	そうめん	fine white noodles	
是非共	ぜひとも	by all means (with sense of not taking "no" for an answer)	
冠詞	かんし	article	
尊敬語	そんけいご	honorific language	
錠剤	じょうざい	pill; lozenge; tablet	
皮膚	ひふ	skin	
塗る	ぬる	spread on; paint	
塗り薬	ぬりぐすり	liniment; ointment; salve	
残す	のこす	to leave; to reserve; to leave undone	
そろそろ	そろそろ	soon; quietly; it is about time to...	
物凄く	ものすごく	extremely	
確認	かくにん	confirmation	
否定形	ひていけい	negative form	
光栄	こうえい	honour; honor; glory; privilege	
街	まち	town; neighborhood; street	
優勝	ゆうしょう	victory; championship	
本州	ほんしゅう	Honshu (island)	
税金	ぜいきん	tax	
結果	けっか	result; outcome	
出社	しゅっしゃ	going to work (e.g. in the morning); coming to work	
掴む	つかむ	to grip; to grab; to catch hold of	
同情	どうじょう	sympathy; compassion	
後輩	こうはい	junior (at work or school)	
調査	ちょうさ	investigation; inquiry	
どちらでもいいです	どちらでもいいです	Both are fine	
奥様	おくさま	married woman; someone's wife	
復習	ふくしゅう	review; revision	
付く	づく	to become (a state, condition, etc.)	
酷い	ひどい	cruel; severe	
九州	きゅうしゅう	Kyushu (island)	
バイト	バイト	part-time job	
骨	ほね	bone; frame; spirit	
購入する	こうにゅうする	purchase	
詐欺	さぎ	swindle; con game	
理想	りそう	ideal	
景色	けしき	scenery; landscape	
栗鼠	りす	squirrel	
正しい	ただしい	correct; righteous; lawful	
我慢	がまん	patience; self-restraint	
秘密	ひみつ	secret; privacy	
情報	じょうほう	information	
お待ち遠様	おまちどおさま	I'm sorry to have kept you waiting	
付き合う	つきあう	associate with; keep company with; come along; go out (date)	
読んできてください	よんできてください	Read it before class	
連絡	れんらく	connection; communication	
視察	しさつ	inspection; observation	
販売	はんばい	sale; selling	
足りる	たりる	to be sufficient; to be enough	
孔雀	くじゃく, くざく	peafowl (peacock, female peahen,　young peachick)	
世話をする	せわをする	take care of someone	
職員室	しょくいんしつ	staff room	
お湯を沸かす	おゆをわかす	boil water	
表情	ひょうじょう	facial expression	
寝る	ねる	to sleep; to go to bed	
天麩羅	てんぷら	tempura; Japanese deep-fried breaded food	
さっき	さっき	some time ago; a little while ago	
除く	のぞく	to rid of; to exclude	
慣れる	なれる	"to get used to; to grow accustomed to; to become familiar with;
to become skilled in"	
～て居る	～ておる	humble version of 〜ている	
環境	かんきょう	environment; surroundings	
出来れば	できれば	if possible	
卵	たまご	egg	
怒る	おこる, いかる	get angry; scold	
世界	せかい	world	
鮫	さめ	shark	
行き成り	いきなり	all of a sudden; without warning	
処分	しょぶん	disposal; dealing (with a problem); punishment; putting down (e.g. animal)	
可能	かのう	possible; potential	
沈菜	キムチ	spicy Korean pickled cabbage; kimchi	
着物	きもの	clothes; kimono	
係の者	かかりのもの	person in charge	
中身	なかみ	content; interior	
支店	してん	branch (of a business, etc.)	
大勢	おおぜい	large numbers; a lot of (people)	
火傷する	やけどする	get burned	
やった	やった	hooray (lit: I or we did it); whee; hot dog!; you beaut; whacko; yowzer!; yes!	
喉が渇く	のどがかわく	(become) thirsty	
文句を言う	もんくをいう	complain	
体育	たいいく	physical training; physical education	
前夜	ぜんや	last night; the previous night	
実践	じっせん	practice; put into practice	
株	かぶ	stocks; shares; stump (of tree)	
両方	りょうほう	both	
生える	はえる	grow; spring up	
別荘	べっそう	villa; vacation home	
お腹が空く	おなかがすく	become hungry	
履歴書	りれきしょ	personal history; resume	
呼び出す	よびだす	call; page	
淹れる	いれる	make tea, coffee, etc.	
奨学金	しょうがくきん	scholarship; fellowship	
結構	けっこう	wonderful; quite; good enough	
失敗	しっぱい	failure; mistake	
黄色い	きいろい	yellow	
パンク	パンク	puncture	
久し振り	ひさしぶり	after a long time	
推薦状	すいせんじょう	letter of recommendation	
感情	かんじょう	emotion; feeling; feelings; sentiment	
診察する	しんさつする	to examine	
提供	ていきょう	offer; provide; program sponsoring;  furnishing; provisioning; supply	
粉薬	こなぐすり	powder medicine	
遣る	やる	do (informal); give; send; run (a store); perform	
目的	もくてき	purpose; goal; aim	
概念	がいねん	general idea; concept	
送別会	そうべつかい	farewell party	
億	おく	hundred million	
訂正	ていせい	correction; amendment	
居なくなる	いなくなる	disappear	
殴る	なぐる	to strike; to hit	
所で	ところで	by the way	
僕	ぼく	I (generally male)	
悪口を言う	わるくちをいう	make a derogatory remark; speak ill of	
日記	にっき	diary	
横断歩道	おうだんほどう	pedestrian crossing; crosswalk	
種	たね	seed	
入院する	にゅういんする	to be hospitalized	
喜び	よろこび	joy; happiness	
脱ぐ	ぬぐ	to take off (clothes, shoes, etc.)	
起こる	おこる	to occur; to happen	
玄米	げんまい	unpolished rice; unmilled rice; brown rice	
次発	じはつ	departing second	
面接	めんせつ	interview	
亡くす	なくす	lose something; lose someone	
産婦人科	さんふじんか	obstetrics and gynecology	
客	きゃく	visitor; customer	
運転免許	うんてんめんきょ	driver's license	
塩	しお	salt	
速達	そくたつ	special delivery; express mail	
認める	みとめる	to recognize; to observe; to notice; to admit	
居る	おる	be present; stay (humble)	
注射	ちゅうしゃ	injection; shot	
以下	いか	not exceeding; and downward; the below-mentioned; the following; the rest	
苛める	いじめる	to tease; to torment; to persecute	
自分で	じぶんで	(do something) by oneself	
びっくりする	びっくりする	to be surprised	
どちら	どちら	which (between two); which way	
丼	どんぶり	bowl of rice with food on top	
札幌	さっぽろ	Sapporo (city)	
足の骨を折りました	あしのほねをおりました	I broke my leg	
眼鏡	めがね	glasses; judgment	
退院	たいいん	discharge from a hospital	
空揚	からあげ	fried (e.g. potatoes, chicken)	
完璧	かんぺき	perfection; perfect	
大統領	だいとうりょう	president	
乗車券	じょうしゃけん	railway ticket; bus ticket	
人生	じんせい	human life; life	
初詣	はつもうで	one's first visit to a shrine in the New Year	
触る	さわる	touch; feel	
ご主人	ごしゅじん	(someone else's) husband	
在庫	ざいこ	inventory; stock; stockpile	
緊張	きんちょう	tension; mental strain; nervousness	
新鮮	しんせん	fresh	
誠に	まことに	indeed; truly; very	
納豆	なっとう	natto (fermented soybeans)	
初め	はじめ	beginning	
痒い	かゆい	itchy	
英語版	えいごばん	English version; non-Japanese version	
大阪	おおさか	Osaka (place name)	
チャーハン	チャーハン	Chinese-style fried rice	
初めて	はじめて	for the first time	
加える	くわえる	to add; to add up; to sum up; to append; to annex	
同僚	どうりょう	colleague; coworker	
怠い	だるい	sluggish; feel heavy; languid; dull	
改札	かいさつ	ticket gate	
霊	れい	soul; spirit; departed soul; ghost	
牛丼	ぎゅうどん	bowl of rice topped with beef	
じゃあ	じゃあ	well...	
病気	びょうき	illness	
海苔	のり	laver (edible seaweed)	
存じ	ぞんじ	knowing	
部下	ぶか	subordinate	
必ずしも	かならずしも	(not) always; (not) necessarily	
～名様	～めいさま	party of ... people	
最初	さいしょ	beginning; outset; first; onset	
能力	のうりょく	ability; capacity	
半ば	なかば	middle; halfway	
不味い	まずい	awful; troublesome; unappetizing	
痛い	いたい	painful	
太い	ふとい	thick; fat	
蹴る	ける	kick	
打つ	うつ	to hit; to strike	
金額	きんがく	amount of money; sum	
変える	かえる	change	
会議	かいぎ	conference; meeting	
初めは	はじめは	at first	
火傷	やけど	burn	
万年筆	まんねんひつ	fountain pen	
仰る	おっしゃる	to say; to speak; to tell (honorific)	
星	ほし	star; suspect (police slang)	
引っ越す	ひっこす	to move; to change quarters	
縫いぐるみ	ぬいぐるみ	stuffed animal	
下痢	げり	diarrhea	
扇子	せんす	paper fan	
咳	せき	cough	
せきが出る	せきがでる	to cough	
海老	エビ	lobster; shrimp	
春	はる	spring	
直ぐ	すぐ	at once; soon	
解釈	かいしゃく	interpretation; explanation	
帽子	ぼうし	hat; cap	
一杯	いっぱい	full; cupful; a lot of	
腰を掛ける	こしをかける	sit down	
鍋物	なべもの	stew; food cooked in a pot	
お祖父さん	おじいさん	grandfather	
遅くなる	おそくなる	become late	
合格	ごうかく	passing an examination; eligibility	
まさか	まさか	by no means; never!; well, I never!; you don't say!	
中	じゅう	throughout (a time period); during; all over	
十億	じゅうおく	billion	
文書	ぶんしょ, もんじょ	document; writing; letter; paperwork; note; records; archives	
国内	こくない	domestic; internal	
風が吹く	かぜがふく	wind blows	
値段	ねだん	price	
存じる	ぞんじる	think; know (humble form)	
松の木	まつのき	pine tree	
泊まる	とまる	stay overnight	
鞄	かばん	bag; handbag; briefcase	
ではまた	ではまた	see you later (used in casual correspondence and conversation); goodbye; sincerely	
指輪	ゆびわ	ring	
髪をとかす	かみをとかす	comb one's hair	
誘う	さそう,いざなう	to invite; to ask out	
出来るだけ	できるだけ	as much as possible	
無くなる	なくなる	to disappear; to run short; to get lost	
展覧会	てんらんかい	exhibition	
地下鉄	ちかてつ	subway	
賛成	さんせい	approval; agreement	
和食	わしょく	Japanese-style food	
品物	しなもの	goods; article; thing	
柔道	じゅうどう	judo	
二つ目の角を左に曲がる	ふたつめのかどをひだりにまがる	turn left at the second corner	
顔をする	かおをする	to look ... (facial expression)	
吃驚	びっくり, きっきょう	to be surprised; to be amazed; to be frightened; to be astonished; surprise	
頂ける	いただける	to receive (potential); to be pretty good; to be exquisite; to be approvable	
寮	りょう	dormitory; lodging house	
出会う	であう	to run into (someone); to meet (someone) by chance	
眺める	ながめる	to look out; to gaze	
最善	さいぜん	the very best	
切り替える	きりかえる	to change; to exchange; to convert; to renew; to throw a switch; to replace	
信号	しんごう	signal; traffic light	
野球場	やきゅうじょう	baseball stadium; baseball field	
発疹	はっしん, ほっしん	rash; eruption	
物足りない	ものたりない	unsatisfied; unsatisfactory	
迎える	むかえる	to welcome; to greet; to go out to meet	
お好み焼き	おこのみやき	savoury pancake with various ingredients	
美術館	びじゅつかん	art museum; art gallery	
警備員	けいびいん	guard	
可哀相	かわいそう	poor; pitiable	
お陰様で	おかげさまで	Thanks to God; thanks to you	
味噌汁	みそしる	miso soup	
昼寝をする	ひるねをする	take a nap	
溜める	ためる	store; collect	
内	うち	inside	
濡らす	ぬらす	wet; moisten	
広場	ひろば	(public) square; open space	
冷やし中華	ひやしちゅうか	chilled Chinese noodles	
全て	すべて	"everything; all; the whole
entirely; completely; wholly; all"	
犯人	はんにん	criminal; offender	
虎	とら	tiger (Panthera tigris); drunkard	
お疲れ様	おつかれさま	thank you; many thanks; much appreciated; that's enough for today	
お礼	おれい	thanks; reward; return present	
盗む	ぬすむ	steal; rob	
ダイエット	ダイエット	(go on a) diet	
猿	さる	monkey (esp. the Japanese macaque, Macaca fuscata); ape; non-human primate	
続く	つづく	continue; follow	
悲しい	かなしい	sad	
誕生日	たんじょうび	birthday	
合計	ごうけい	sum total	
浴びる	あびる	to take (a shower)	
宇宙人	うちゅうじん	alien; extraterrestrial	
骨折	こっせつ	fracture; broken bone	
上る	のぼる	go up	
標準語	ひょうじゅんご	standard language (of a country); standard Japanese	
に取って	にとって	to; for; concerning; as far as ... is concerned; regarding	
たこ焼き	たこやき	octopus dumplings	
雷	かみなり	thunder; lightning	
眠い	ねむい	sleepy	
兎に角	とにかく	anyhow; at any rate; anyway; somehow or other; generally speaking; in any case	
壁	かべ	wall; partition	
換える	かえる	exchange; convert	
九十	きゅうじゅう	ninety	
スイッチ	スイッチ	switch	
では	では	then; in that case; well then	
心臓	しんぞう	heart (organ)	
ビデオカメラ	ビデオカメラ	camcorder; video camera	
鵞鳥	がちょう	goose	
貼る	はる	stick; paste	
理解	りかい	understanding; comprehension	
大抵	たいてい	generally; mostly; usually	
昼	ひる	daytime; midday; noon	
耳鼻科	じびか	otolaryngology; ENT	
基本	きほん	basis; foundation	
お腹を壊す	おなかをこわす	have a stomachache/diarrhea	
褒める	ほめる	to praise; to commend	
若い	わかい	"young; youthful
immature; green
low (number); small"	
黒板	こくばん	blackboard	
結局	けっきょく	after all; finally	
封筒	ふうとう	envelope	
用事	ようじ	things to do; errand; business	
検札	けんさつ	ticket check	
羨ましい	うらやましい	envious; envy	
御尻	おしり	buttocks	
夫妻	ふさい	husband and wife; Mr. and Mrs.	
ホーム	ホーム	(train) platform	
歯医者	はいしゃ	dentist	
数分後	すうふんご	a few minutes later; after a few minutes	
蝋燭	ろうそく	candle	
答え	こたえ	response; reply; answer; solution	
北海道	ほっかいどう	Hokkaido prefecture (of the 道 kind) and northernmost of the main islands in Japan	
家賃	やちん	rent	
積もり	つもり	intention; purpose	
着替える	きがえる	to change one's clothes	
募集	ぼしゅう	recruiting; taking applications	
以上	いじょう	not less than; ... and more; ... and upwards	
種類	しゅるい	kind; species	
御存知	ごぞんじ	knowing (honorific); acquaintance	
今週末	こんしゅうまつ	this weekend	
蛇足	だそく	redundancy; superfluity; useless addition	
意訳	いやく	free translation; liberal translation	
続き	つづき	continuation; sequel	
片道	かたみち	one way	
十三分	じゅうさんぷん	thirteen minutes	
鉄拳	てっけん	fist	
昨夜	さくや, ゆうべ	last night; last evening	
詰まらない	つまらない	dull; uninteresting; boring; tedious	
気分が悪い	きぶんがわるい	feel sick	
幼稚園	ようちえん	kindergarten	
検出	けんしゅつ	detection; sense (e.g. sensor)	
数分	すうふん	several minutes; a few minutes	
判断	はんだん	judgment; decision	
教壇	きょうだん	platform	
治る	なおる	to be cured; to get well	
滝	たき	waterfall	
観光	かんこう	sightseeing	
代える	かえる	substitute; use in place of	
醤油	しょうゆ	soy sauce	
首	くび	neck; head	
くだけた言い方	くだけたいいかた	colloquial expression	
途中	とちゅう	on the way; midway; en route	
二十日	はつか	twenty days; the twentieth (day)	
順番	じゅんばん	(in) order; taking turns	
素晴らしいです	すばらしいです	That's great	
集まる	あつまる	to gather; to collect; to get together	
息子	むすこ	son	
大事	だいじ, おおごと	important; serious matter	
丁寧	ていねい	polite; courteous; careful	
宇宙	うちゅう	universe; space	
振り掛け	ふりかけ	dried food sprinkled over rice; fish flour	
怠け者	なまけもの	lazy person	
霧	きり	fog; mist	
福袋	ふくぶくろ	lucky-dip bag; grab bag	
別れる	わかれる	to be divided; to separate;	
正月	しょうがつ	New Year; New Year's Day; January	
えっと	えっと	let me see; well; errr ...	
一時半	いちじはん	one thirty	
弾く	ひく	play (guitar, piano)	
劇場	げきじょう	theater	
熱	ねつ	heat; fever	
午前	ごぜん	morning; a.m.	
返る	かえる	be restored to; return to	
沖縄	おきなわ	Okinawa (island)	
都庁	とちょう	Tokyo Government Office	
秒	びょう	second (interval of time)	
締める	しめる	tie; fasten	
特急	とっきゅう	super express; limited express (train)	
貯金	ちょきん	savings; deposit	
いや	いや	no (casual)	
計画を立てる	けいかくをたてる	make a plan	
感じ	かんじ	feeling; impression	
使う	つかう	to use	
こんな風	こんなふう	(in) this way	
事故	じこ	accident; incident	
塾	じゅく	cram school	
決める	きめる	to decide; to choose; to make up one's mind; to agree upon	
お握り	おにぎり	rice ball (often triangular, sometimes with a filling and wrapped in nori)	
無駄遣い	むだづかい	wasting money	
御座る	ござる	to be	
豆腐	とうふ	tofu	
予報	よほう	forecast; prediction	
お祖母さん	おばあさん	grandmother; female senior citizen	
参加	さんか	participation	
元旦	がんたん	New Year's Day	
舐める	なめる	lick; lap	
伺う	うかがう	ask; visit (humble)	
時間が掛る	じかんがかかる	take time	
弁護士	べんごし	lawyer; attorney	
お子さん	おこさん	(someone's) child (honorifc)	
頑張って	がんばって	hold on; go for it; keep at it; good luck; hang in there; do your best!	
就職	しゅうしょく	finding employment	
留守	るす	not at home	
煙草	たばこ	tobacco; cigarette	
下りる	おりる	go down; come down	
がっかりする	がっかりする	be disappointed	
餌	えさ	bait; feed	
シャツ	シャツ	shirt	
頭	あたま	head	
勝つ	かつ	to win	
方法	ほうほう	method; procedure	
頑張る	がんばる	persist; be tenacious	
スニーカー	スニーカー	sneakers	
成る	なる	to become	
親子丼	おやこどん	bowl of rice topped with chicken and eggs	
アイロンをかける	アイロンをかける	to iron clothes	
文章	ぶんしょう	sentence; writing; prose	
詳しい	くわしい	detailed; full; accurate; knowing very well	
～行目	～ぎょうめ	line number...	
伝える	つたえる	to convey; to report; to transmit; to communicate; to tell	
消費者	しょうひしゃ	consumer	
同じです	おなじです	Same thing	
象	ぞう	elephant	
今すぐ	いますぐ	right away	
娘さん	むすめさん	daughter; young woman	
美容院	びよういん	beauty shop	
記事	きじ	article; story	
終わる	おわる	to finish; to end; to close	
電池	でんち	battery	
続ける	つづける	to continue; to keep up; to keep on	
歯科	しか	dentistry	
謝る	あやまる	to apologize	
助ける	たすける	to help; to save	
茶	ちゃ	tea; light brown	
戻ってくる	もどってくる	come back	
団子	だんご	rice dumpling	
木	き	tree; wood	
ポスター	ポスター	poster	
致す	いたす	to do (humble)	
ジャーナリスト	ジャーナリスト	journalist	
的	てき	-like; typical	
貧乏	びんぼう	poverty; destitute; poor	
辞書	じしょ	dictionary	
茶碗	ちゃわん	tea cup; rice bowl	
手術する	しゅじゅつする	to have an operation	
大丈夫ですよ	だいじょうぶですよ	It's OK.	
宇宙飛行士	うちゅうひこうし	astronaut	
廊下	ろうか	hallway; corridor	
必ず	かならず	without fail; certainly	
男	おとこ	man; male	
気を悪くする	きをわるくする	to take offense (at); to take offence (at); to feel hurt (by)	
夫	おっと	husband	
給料	きゅうりょう	salary; pay	
失礼	しつれい	discourtesy; impoliteness; to be rude; to leave; Excuse me; Goodbye	
止める	とめる	to stop (a car); to turn off	
草	くさ	grass; weed	
取る	とる	to take; to pick up; to harvest; to earn; to choose; to steal; to take off (one's glasses, etc.)	
よろしくお伝えください	よろしくおつたえください	please give my best regards	
向こう	むこう	the other side; the other party; opponent	
空ける	あける	empty; clear out	
制服	せいふく	uniform	
取りあえず	とりあえず	at once; first of all; for the time being; for now	
高い	たかい	high; tall; expensive	
準備	じゅんび	preparation; setup; arrangements	
ご覧になる	ごらんになる	to see (honorific)	
飛行機	ひこうき	airplane	
撃墜	げきつい	shooting down (aircraft)	
有る	ある	exist; possess; there is/are (inanimate objects)	
無駄	むだ	no good; pointless	
半分	はんぶん	half	
習慣	しゅうかん	custom; habit	
ところで	ところで	by the way	
日毎に	ひごとに	daily	
屹度	きっと	surely, certainly; sternly	
欲しい	ほしい	want; desire	
借りる	かりる	to borrow; to rent	
もう一度言って下さい	もういちどいってください	Please say it again.	
下らない	くだらない	pointless; worthless; insignificant; good-for-nothing; stupid	
書類	しょるい	documents; papers	
誉める	ほめる	to praise	
原宿	はらじゅく	Harajuku (in Tokyo)	
今朝	けさ	this morning	
朝食	ちょうしょく	breakfast	
空気	くうき	air; atmosphere	
住所	じゅうしょ	address; one's dwelling	
振る	ふる	to wave; to shake; to brandish; to reject (someone)	
消費	しょうひ	consumption; spending	
～ていらっしゃる	～ていらっしゃる	honorific expression for 〜ている	
得意	とくい	one's forte; pride; customer	
どう致しまして	どういたしまして	you are welcome; don't mention it; not at all; my pleasure	
麺類	めんるい	noodles; vermicelli	
ペラペラ	ペラペラ	fluently	
専門家	せんもんか	specialist; expert	
世直し	よなおし	world reformation	
突然	とつぜん	abruptly; suddenly	
一つ目の信号を右に曲がる	ひとつめのしんごうをみぎにまがる	turn right at the first traffic light	
結構です	けっこうです	That would be fine.; That wouldn't be necessary.	
いらっしゃいませ	いらっしゃいませ	welcome (to our store)	
寂しい	さびしい,さみしい	lonely; desolate; sad	
去る	さる	to go away; to leave	
厭	いや	unfavorable; unpleasant; hateful	
素晴らしい	すばらしい	splendid; excellent	
手術	しゅじゅつ	surgical operation	
手袋	てぶくろ	gloves	
年賀状	ねんがじょう	New Year's card	
海豚	いるか	dolphin (or other small toothed whales, such as porpoises, belugas, etc.)	
座布団	ざぶとん	cushion	
黒木	くろき	Kuroki (family name)	
～てご座る	～てござる	humble version of です	
枯れる	かれる	wither; die	
大根	だいこん	daikon radish; oriental radish	
蚊	か	mosquito	
お守り	おまもり	charm; amulet	
相談	そうだん	consultation; discussion	
高速	こうそく	high speed	
諦める	あきらめる	to abandon; to give up	
狼	おおかみ	wolf (carnivore, Canis lupus)	
コート	コート	coat; jacket; (tennis) court	
番号	ばんごう	number; series of digits	
割引券	わりびきけん	discount coupon	
徹夜	てつや	staying up all night	
招待する	しょうたいする	to invite	
限る	かぎる	to restrict; to limit; to confine	
髪	かみ	hair; hairstyle	
ようこそ	ようこそ	welcome	
人気がある	にんきがある	be popular	
被る	かぶる	to wear (on head); to put on	
通る	とおる	to pass (by); go through	
外科	げか	surgery	
財布	さいふ	purse; wallet	
放っておく	ほっておく	leave (someone/something) alone; neglect	
要は	ようは	in a word; in short	
感謝	かんしゃ	gratitude; thanks	
靴下	くつした	socks; stockings	
謙譲語	けんじょうご	humble language (e.g. itadaku)	
引っ越し	ひっこし	moving; changing residence	
表現	ひょうげん	expression; presentation; representation; notation (Mathematics)	
すぐに	すぐに	instantly; immediately	
自由	じゆう	freedom; free	
列	れつ	row; line	
風	かぜ	wind	
背中がかゆいです	せなかがかゆいです	I have an itchy back	
良さげ	よさげ	good appearing; (of) good appearance	
怪我をする	けがをする	to get injured	
降りる	おりる	to get off; to land; to descend	
早い	はやい	early	
猪	いのしし	wild boar; hog	
道を渡る	みちをわたる	cross the street	
砂糖	さとう	sugar	
指	ゆび	finger; toe	
濡れる	ぬれる	to get wet	
試験	しけん	test; examination	
俳優	はいゆう	actor; actress	
子供	こども	child	
好む	このむ	to like; to be fond of	
元気でね	げんきでね	Take care of yourself.	
兼ねる	かねる	to serve or combine two functions; to find difficult (unpleasant, awkward, painful)	
例えば	たとえば	for example	
意外	いがい	unexpected; unforeseen	
手短	てみじか	short; brief	
繰り返す	くりかえす	to repeat; to do something over again	
鍵	かぎ	key; lock	
教室	きょうしつ	classroom	
活動	かつどう	activity, function	
更に	さらに	furthermore; still more	
蕎麦	そば	buckwheat noodles; soba	
到着	とうちゃく	arrival	
そうそう	そうそう	That's right.	
牛肉	ぎゅうにく	beef	
撮る	とる	take (pictures); shoot (film)	
饂飩	うどん	noodles; Japanese wheat noodles	
挨拶	あいさつ	greet; greeting	
警察官	けいさつかん	police officer	
出発	しゅっぱつ	departure	
謙遜	けんそん	humility; modesty	
やっと	やっと	at last; finally	
免許	めんきょ	license; permit	
来年	らいねん	next year	
八日	ようか	eight days; eighth day of the month	
物価	ぶっか	prices	
実際	じっさい	practicality; practical; reality	
古い	ふるい	old	
熊	くま	a bear	
整形外科	せいけいげか	orthopedics; reconstructive surgery	
知っています	しっています	I know	
持ってくる	もってくる	bring (something) along	
お金持ち	おかねもち	rich person	
飛び出す	とびだす	to jump out; to fly out; to dash out	
合う	あう	merge; fit; match; suit; unite	
お土産	おみやげ	souvenir	
忘れる	わすれる	to forget; to be forgetful of	
お願い	おねがい	please; favor	
連れて帰る	つれてかえる	take (someone) home	
文化	ぶんか	culture; civilization	
気が付く	きがつく	notice; become aware of	
平気	へいき	nonchalant; calm	
餡子	あんこ	red bean paste; red bean jam; anko; filling (e.g. of a manjuu)	
幸せ	しあわせ	happiness; good fortune	
鯨	くじら	whale	
焼く	やく	to grill; bake; burn; be envious	
黄色	きいろ	yellow	
遊ぶ	あそぶ	to play	
時代	じだい	age; era; antiquity	
楽	らく	comfort; ease; raku pottery	
技術	ぎじゅつ	skill; technology	
括弧	かっこ	parentheses; brackets	
本当は	ほんとうは	in fact; originally	
娘	むすめ	daughter; girl	
宜しく	よろしく	well; properly; suitably; best regards	
皿	さら	plate; counter for plates or helpings	
丁寧語	ていねいご	polite language (i.e. masu, desu, etc.)	
経験	けいけん	experience	
兆	ちょう	trillion	
階段	かいだん	steps; flight of stairs	
方面	ほうめん	direction	
負ける	まける	to lose, to be defeated	
場所	ばしょ	place; space	
焼き鳥	やきとり	grilled chicken on skewer	
国際関係	こくさいかんけい	international relations	
性格	せいかく	character; personality	
歌	うた	song	
かたい言い方	かたいいいかた	bookish expression	
踏む	ふむ	step on; tread on	
汚す	よごす	pollute; make dirty; to disgrace	
転勤	てんきん	job transfer	
登録	とうろく	registration	
電気屋	でんきや	electric appliance store	
二十分	にじゅっぷん,にじっぷん	twenty minutes	
蝿	はえ	fly	
それに	それに	besides; in addition; also; moreover	
鰻	うなぎ	eel	
間に	あいだに	while	
手をあげてください	てをあげてください	Please raise your hand	
最悪	さいあく	the worst	
投稿	とうこう	contribute (an article)	
答える	こたえる	to answer; to reply	
竜	たつ,　りゅう	dragon; imperial	
重い	おもい	heavy	
始まる	はじまる	to begin	
飴	あめ	(hard) candy; toffee	
すごく	すごく	extremely	
蛸	タコ	octopus	
御神籤	おみくじ	written oracle	
彼女	かのじょ	she; one's girlfriend	
信じる	しんじる	believe; trust; have faith in	
黒猫	くろねこ	black cat	
焼き魚	やきざかな	grilled fish	
損失	そんしつ	loss (e.g. assets or profits)	
鴨	かも	duck; easy mark; sucker; sitting duck	
来	らい	next (year, etc.); since (last month, etc.)	
意味	いみ	meaning; significance	
不安	ふあん	uneasiness; anxiety	
儘	まま, まんま	as it is; as one likes; because; as; condition; state	
餡パン	あんパン	bread roll filled with anko	
時々	ときどき	sometimes	
台所	だいどころ	kitchen	
違う	ちがう	differ; not match the correct (answer, etc.)	
生理	せいり	period; menstruation	
薬局	やっきょく	drugstore; pharmacy	
開く	あく	to open (business, door, eyes, mouth, etc.); to be empty; to be available	
鼻水	はなみず	nasal mucus; dripping nose	
ハイヒール	ハイヒール	high heels	
返品	へんぴん	return (merchandise)	
吐く	はく	to spit; to vomit; to belch; to confess; to tell (lies)	
夏	なつ	summer	
お年玉	おとしだま	New Year's gift	
上着	うわぎ	coat; jacket	
渡る	わたる	cross; ford; go across	
狭い	せまい	narrow; confined	
早速	さっそく	immediately; without delay; promptly	
政府	せいふ	government; administration	
余裕	よゆう	surplus; room; leeway	
暇つぶし	ひまつぶし	waste of time; killing time	
消しゴム	けしごむ	eraser	
番組	ばんぐみ	program	
書留	かきとめ	registered mail	
経済	けいざい	economy; economics	
数学	すうがく	mathematics	
将来	しょうらい	future; in the future	
川口市	かわぐちし	Kawaguchi (city)	
長野	ながの	Nagano (prefecture/city)	
絶対に	ぜったいに	absolutely; unconditionally	
助けて	たすけて	help!	
必要	ひつよう	need; necessity	
呼ぶ	よぶ	call; name; invite	
笑顔	えがお	smiling face; smile	
心配	しんぱい	worry; concern; anxiety; assistance	
蜂	ハチ	bee; wasp; hornet	
お世話	おせわ	help; aid; assistance	
九才	きゅうさい	nine years old	
困る	こまる	be at a loss; in a jam; in trouble	
もやし	もやし	bean sprouts	
売る	うる	to sell	
料理	りょうり	cooking; handling	
他の	たの, ほかの	other (た is more formal)	
ぐらい	ぐらい	about; approximately	
久しぶり	ひさしぶり	for the first time in a long time; It's been a long time since I saw you	
横	よこ	side; width across; horizontal	
翻訳	ほんやく	translation	
～目	～め	-th (ordinal number suffix)	
学ぶ	まなぶ	to learn; to study	
正解	せいかい	right answer; correct solution	
難しい	むずかしい	difficult	
悩み	なやみ	troubles; worries	
大切にする	たいせつにする	to value; treasure; think a great deal of	
助かる	たすかる	to be saved; to be rescued; to be helpful	
価値	かち	value; merit	
泥棒	どろぼう	thief; crook	
下さる	くださる	give; favor with (honorific)	
ほぼ	ほぼ	almost; nearly	
交換	こうかん	exchange; bartering	
朝寝坊	あさねぼう	oversleep	
髭を剃る	ひげをそる	shave one's beard	
梅雨入り	つゆいり	start of the rainy season	
約束	やくそく	promise; pact	
国際電話	こくさいでんわ	international call/telephone	
家族	かぞく	family; members of a family; household	
鶏肉	とりにく	chicken meat	
削る	けずる	grind down; trim; scale back	
退院する	たいいんする	to get out of the hospital	
部長	ぶちょう	section chief; department head	
病気が治る	びょうきがなおる	recover from (sickness), get well	
抗生物質	こうせいぶっしつ	antibiotic	
レコード	レコード	record	
悪い	わるい	bad	
晴れる	はれる	be sunny; clear up	
禿げ頭	はげあたま	bald head; baldness	
地震	じしん	earthquake	
蛍	ほたる	firefly; lightning bug	
主婦	しゅふ	housewife	
一人暮らし	ひとりぐらし	living alone	
夢	ゆめ	dream	
差し上げる	さしあげる	give (humble)	
動画	どうが	animation; motion picture; moving image; video; in-betweening (in anime)	
畏まりました	かしこまりました	Certainly. (accepting an order or request)	
待たせる	またせる	keep (someone) waiting	
基本的	きほんてき	fundamental; standard; basic	
めまい	めまい	dizziness; giddiness; vertigo	
出張	しゅっちょう	business trip; official tour	
プール	プール	pool	
工場長	こうじょうちょう	factory (works) manager	
開ける	あける	to open	
寒い	さむい	cold (air, weather)	
所	ところ	place	
乗る	のる	to ride; board	
灰色	はいいろ	ash color; gray	
米	こめ	rice (raw)	
コピーを取る	コピーをとる	make a photocopy	
都合が悪い	つごうがわるい	inconvenient	
嘘	うそ	lie	
巻きす	まきす	"sushi mat" (bamboo mat used in food preparation, especially to roll makizushi)	
携帯	けいたい	cell phone; portable; carry	
ところが	ところが	but; on the contrary...	
である	である	to be (formal, literary)	
高速道路	こうそくどうろ	freeway; highway	
富士山	ふじさん	Mt. Fuji	
十二分	じゅうにふん	twelve minutes	
普通	ふつう	normal; regular; general; ordinary	
賑やか	にぎやか	lively; exciting	
授業料	じゅぎょうりょう	tuition fee	
小学校	しょうがっこう	elementary school; primary school	
興味	きょうみ	interest (in something)	
氷	こおり	ice	
お茶	おちゃ	tea	
京都	きょうと	Kyoto	
別に	べつに	(not) particularly; separately; apart	
調べる	しらべる	investigate; check	
此の位	このぐらい	about this much	
居る	いる	to be; to exist (person); to stay at...	
盛大	せいだい	grand; prosperous; magnificent	
易しい	やさしい	easy; simple	
井戸	いど	water well	
出身	しゅっしん	person's origin	
一昨年	おととし, いっさくねん	the year before last	
喧嘩	けんか	fight; quarrel; brawl	
授業中に	じゅぎょうちゅうに	in class; during the class	
黒	くろ	black	
家具	かぐ	furniture	
急行	きゅうこう	moving at high speed; express (e.g. train that bypasses many stations)	
失礼します	しつれいします	Excuse me.; I must be going now.	
野球	やきゅう	baseball	
どの位	どのぐらい	how much (long, far, etc.)	
為さる	なさる	to do (honorific)	
演奏	えんそう	musical performance	
轢く	ひく	to run over	
全部	ぜんぶ	all; wholly; all in all	
玄関	げんかん	entranceway; front door; area where shoes are kept	
間に合う	まにあう	to be in time for; to serve the purpose	
登る	のぼる	climb; mount; ascend	
旅館	りょかん	Japanese inn	
～側	～がわ	side	
蜻蛉	とんぼ, とんぼう, せいれい	dragonfly; damselfly	
鼻	はな	nose	
図書館	としょかん	library	
汚い	きたない	dirty	
親戚	しんせき	a relative	
刺す	さす	stab; prick; sting	
仲がいい	なかがいい	be on good terms; get along well	
便秘	べんぴ	constipation	
おじゃまします	おじゃまします	Thank you (for allowing me to come in)	
二十	にじゅう	20	
盆踊り	ぼんおどり	Bon Festival dance	
音	おと,ね	sound; noise	
約	やく	approximately; about	
文句	もんく	complaint; phrase	
画面	がめん	screen	
雰囲気	ふんいき	atmosphere; mood	
育てる	そだてる	to bring up; to raise; to breed; to train	
津波	つなみ	tsunami; tidal wave	
煩い	うるさい	noisy; bothersome	
今度	こんど	this time; next time; one of these days	
とにかく	とにかく	in any case; anyway	
体温計	たいおんけい	thermometer	
最高	さいこう	maximum; supreme	
餃子	ぎょうざ	Chinese dumpling	
直訳	ちょくやく	literal translation; direct translation	
英会話	えいかいわ	English conversation	
そんな	そんな	such; that kind of	
政治	せいじ	politics	
切手	きって	postage stamp	
迎えに行く	むかえにいく	go to pick someone up	
ライオン	ライオン	lion	
胡麻	ごま	sesame (seeds)	
運ぶ	はこぶ	to carry; to transport; to move	
イカ	イカ	squid; cuttlefish	
粉	こな,こ	powder; flour	
洞窟	どうくつ	cave	
氷山	ひょうざん	iceberg	
会話	かいわ	conversation	
勘弁	かんべん	pardon; forgiveness; forbearance	
二人ずつ	ふたりずつ	couple	
お疲れ様でした	おつかれさまでした	Thanks for the hard work; That's enough for today	
埋め合わせ	うめあわせ	compensation	
参る	まいる	go; come; be defeated; collapse; be annoyed; visit (shrine; grave)	
授業	じゅぎょう	class; lesson; classwork	
看護士	かんごし	(male) nurse	
後	ご	after (usually suffix)	
仕舞う	しまう	to finish; to put away	
おや	おや	Oh!; Good heavens!	
近所	きんじょ	neighborhood	
選挙	せんきょ	election	
お元気ですか	おげんきですか	How are you? (literally: Are you well)?	
鳥	とり	bird	
次	つぎ	next	
釣り	つり	fishing; angling; change (money)	
男の人	おとこのひと	man	
人形	にんぎょう	doll	
御苦労様	ごくろうさま	thank you very much for your..., I appreciate your efforts	
太陽	たいよう	sun	
嵐	あらし	storm	
研究	けんきゅう	research; study	
ゆっくり	ゆっくり	slowly	
目茶苦茶	めちゃくちゃ	in a mess; terrible	
季節外れ	きせつはずれ	unseasonable; out of season	
道理で	どうりで	indeed; it's no wonder	
追加	ついか	addition; supplement; append	
五	ご	five	
是非	ぜひ	by all means; at any cost	
電話をかける	でんわをかける	to make a phone call	
成績	せいせき	results; record; grades	
御父さん	おとうさん	father (honorific)	
女優	じょゆう	actress	
夏休み	なつやすみ	summer vacation	
悲劇的	ひげきてき	tragic	
北	きた	north	
豚肉	ぶたにく	pork; hog meat	
鯉	こい	common carp; koi carp	
家事	かじ	housework; domestic duties	
顔	かお	face	
御苦労	ごくろう	trouble (I have put you through)	
似る	にる	resemble; be alike	
神様	かみさま	god; the divine	
妹	いもうと	younger sister	
紙	かみ	paper	
尋ねる	たずねる	to inquire; to search for	
狐	きつね	fox	
雲	くも	cloud	
只	ただ	ordinary; usual; free of charge; as is; safe; only; merely; simply; but; however	
予習	よしゅう	preparation; previewing (a lesson)	
毛虫	けむし	hairy caterpillar; woolly bear; pest; nudnik (nudnick)	
化粧	けしょう	make up; put on makeup	
言い出す	いいだす	begin to speak	
夜	よる,よ	night; evening	
タイヤ	タイヤ	tire	
規則	きそく	rules; regulations	
傍	そば	near; beside	
市民病院	しみんびょういん	municipal hospital	
鹿	しか	deer (esp. the sika deer, Cervus nippon)	
地下	ちか	basement; underground	
熱がある	ねつがある	have a fever	
投げる	なげる	to throw; to abandon	
庭	にわ	garden; court	
運転	うんてん	drive	
電気	でんき	electricity; electric light	
注意	ちゅうい	attention; care; watch out	
大人	おとな	adult	
知りません	しりません	I do not know	
止める	やめる	to stop (doing something); quit; give up	
四つ	よっつ	four (things)	
梅雨	つゆ,ばいう	rainy season	
喫茶店	きっさてん	café; coffee shop;  tearoom	
泳ぐ	およぐ	swim	
離婚	りこん	divorce	
ボール	ボール	ball	
畑	はたけ	field; vegetable garden	
泉	いずみ	spring; fountain	
比べる	くらべる	compare; contrast	
先発	せんぱつ	forerunner; advance party; going on ahead; starting	
小説	しょうせつ	novel; story	
宿題	しゅくだい	homework	
付け加える	つけくわえる	to add one thing to another	
反対	はんたい	opposition; contrast; opposite	
胸	むね	chest (body)	
発表	はっぴょう	announcement; publication	
受ける	うける	to receive; to get; to catch (e.g. a ball); to be struck by (wind, waves, sunlight, etc.); to take (a test, an interview); to accept	
山葵	わさび	wasabi; Japanese horseradish	
馬鹿にする	ばかにする	insult; make a fool of	
飼う	かう	raise (a pet); keep	
桜の木	さくらのき	cherry tree	
餅	もち	rice cake	
持つ	もつ	to hold; to possess	
外	そと	outside; exterior	
指定席	していせき	reserved seat	
十四	じゅうし,じゅうよん	fourteen	
点く	つく	to be lit (e.g. electricity comes on); to catch fire	
甘い	あまい	sweet	
送る	おくる	to send (a thing); to dispatch; to escort (a person somewhere); to see off; to bid farewell	
遠慮	えんりょ	reserve; hesitation; forethought	
言い訳	いいわけ	apology; excuse	
肉まん	にくまん	manju (steamed bun) with meat filling	
寄る	よる	to visit; to drop in; to approach	
肩	かた	shoulder	
御先	おさき	going before; the future	
道路	どうろ	road; street	
知る	しる	to know	
通う	かよう	go to and from; frequent a place	
髭	ひげ	moustache; beard	
細い	ほそい	thin; slender	
感動	かんどう	emotion; impression	
一日	いちにち	one day	
嬉しい	うれしい	happy; glad	
選ぶ	えらぶ	choose; elect	
花粉症	かふんしょう	pollen allergy	
怪我	けが	injury	
食堂	しょくどう	dining hall; cafeteria	
回数券	かいすうけん	book of tickets	
召し上がる	めしあがる	eat; drink (honorific)	
誤る	あやまる	make a mistake	
日本	にほん, にっぽん	Japan	
時刻	じこく	clock time; time of day	
立派	りっぱ	splendid; handsome; elegant; prominent; legitimate	
信じられない	しんじられない	Unbelievable!	
一時的	いちじてき	temporary	
拾う	ひろう	pick up; find	
ばつ	ばつ	circumstances or condition, esp. compared to that of another; x-mark (in a test)	
円い	まるい	round; spherical; harmonious	
貸す	かす	to lend; to loan	
バス停	バスてい	bus stop	
温かい	あたたかい	warm; mild; genial	
旅行する	りょこうする	to travel	
瞬間	しゅんかん	instant; moment	
十七分	じゅうななふん	seventeen minutes	
サボる	サボる	cut classes	
子	こ	child; kid	
力仕事	ちからしごと	physical labor	
喋る	しゃべる	chat; talk	
烏	カラス	crow; raven	
背が低い	せがひくい	short (person)	
間違える	まちがえる	to make a mistake; to confuse	
野球選手	やきゅうせんしゅ	baseball player; ballplayer	
人	ひと	person	
無くす	なくす	lose; get rid of	
回る	まわる	to turn; to revolve	
速い	はやい	fast	
移る	うつる	to move; to shift	
乗り遅れる	のりおくれる	to miss (train, bus, etc.)	
随分	ずいぶん	very; extremely	
切る	きる	to cut; to cut through	
代わり	かわり	substitution	
のんびり	のんびり	carefree; at leisure	
お手洗い	おてあらい	restroom; toilet; bathroom	
興味がある	きょうみがある	be interested in	
工学	こうがく	engineering	
頂く	いただく	to receive; to eat; to drink (humble)	
牛	うし	cow; cattle	
勿論	もちろん	of course; no doubt	
湖	みずうみ	lake	
敬語	けいご	honorific language; polite speech	
詰まり	つまり	in short; basically; that is to say...	
六つ	むっつ	six (things)	
離れる	はなれる	to be separated from; to leave	
便利	べんり	convenience; handiness	
お勘定をお願いします	おかんじょうをおねがいします	May I have the check, please?	
交差点	こうさてん	crossing; intersection	
分ける	わける	divide into parts; sort; share	
遅く	おそく	(do something) late	
編む	あむ	knit	
可愛い	かわいい	cute; charming; sweet	
母	はは	mother	
高校生	こうこうせい	high school student	
駅	えき	station	
短い	みじかい	short (length)	
コロッケ	コロッケ	croquette	
刺身	さしみ	sashimi (sliced raw fish)	
枝豆	えだまめ	edamame (green soybeans)	
東	ひがし	east	
アジア研究	アジアけんきゅう	Asian studies	
覚える	おぼえる	memorize; remember; learn	
丘	おか	hill; slope	
お米	おこめ	rice	
使えません	つかえません	Can't be used	
戻る	もどる	to return (to a place); turn back	
今日中に	きょうじゅうに	by the end of today	
禿げる	はげる	to lose hair	
落とす	おとす	to drop; to lose; to remove	
荷物	にもつ	baggage; load	
事務所	じむしょ	office; one's place of business	
蜜柑	みかん	tangerine; mandarin orange	
保険に入る	ほけんにはいる	buy insurance	
受付	うけつけ	receptionist; information desk	
教科書	きょうかしょ	textbook; schoolbook	
始め	はじめ	beginning; origin	
ご存じ	ごぞんじ	know (honorific)	
残念	ざんねん	regret; bad luck; disappointment	
～番	～ばん	number (in a series); (one's) turn; guard; lookout; match (sumo)	
お宅	おたく	somebody's house (polite expression)	
二人	ふたり	two people	
～台	～だい	counter for cars and machines	
蟻	あり	ant	
勉強する	べんきょうする	to study	
五百	ごひゃく, いお	five hundred; many	
落ち込む	おちこむ	get depressed	
三日	みっか	three days; third of the month	
学割	がくわり	student discount	
お腹	おなか	stomach	
静か	しずか	quiet; tranquil	
直ぐに	すぐに	instantly; immediately; right away; at once	
かっこいい	かっこいい	cool; great-looking	
変	へん	strange; weird; change	
お休みになる	おやすみになる	sleep (honorific)	
自由席	じゆうせき	non-reserved seat	
再来週	さらいしゅう	the week after next	
直る	なおる	to be repaired; to be returned to normal	
～階	～かい	floor (of a building)	
日本語	にほんご	Japanese language	
一緒	いっしょ	together	
五才	ごさい	five years old	
石鹸	せっけん	soap	
お嬢さん	おじょうさん	daughter; young lady	
掏る	する	pick someone's pocket	
気温	きおん	atmospheric temperature	
綺麗	きれい	beautiful; lovely; clean	
空港	くうこう	airport	
冷蔵庫	れいぞうこ	refrigerator	
真っ直ぐ	まっすぐ	dead straight; honestly	
簡単	かんたん	simple; easy	
縦	たて	vertical; length; height	
要る	いる	to need; to require	
セーター	セーター	sweater; pullover	
意地悪	いじわる	malicious; ill-tempered; unkind	
ていねいな言い方	ていねいないいかた	polite expression	
通り	とおり	avenue; street	
名刺	めいし	business card; calling card	
話をする	はなしをする	have a talk	
旅行	りょこう	travel; trip	
遅刻	ちこく	tardiness; lateness	
先輩	せんぱい	senior; superior	
格好いい	かっこいい	good looking; "cool"	
寿司	すし	sushi	
其処	そこ	there	
鋭い	するどい	pointed; sharp	
間	あいだ	space or time (between); gap; interval; distance; span	
お寺	おてら	temple (honorific)	
着る	きる	to wear (on upper body); put on	
夕食	ゆうしょく	dinner; supper	
安全	あんぜん	safety; security	
毎晩	まいばん	every evening	
十万	じゅうまん	one hundred thousand	
本	ほん	book; volume; counter for long things	
嘘を吐く	うそをつく	tell a lie	
また後で	またあとで	see you later	
週末	しゅうまつ	weekend	
木曜日	もくようび	Thursday	
目覚まし時計	めざましどけい	alarm clock	
会社員	かいしゃいん	company employee	
河	かわ	river; stream	
発音	はつおん	pronunciation	
御免下さい	ごめんください	May I come in?	
家内	かない	(my) wife	
来学期	らいがっき	next semester	
吐きました	はきました	I threw up	
奢る	おごる	to treat (someone)	
曇る	くもる	become cloudy	
相手	あいて	partner; other person; opponent (game)	
弱い	よわい	weak; frail	
皆で	みんなで	everybody together	
浴衣	ゆかた	yukata; informal summer kimono	
眼鏡をかける	めがねをかける	to wear glasses	
痴漢	ちかん	molester; pervert	
宜しかったら	よろしかったら	if it is okay (polite)	
文学	ぶんがく	literature	
会社	かいしゃ	company; corporation	
大好き	だいすき	to love; like a lot	
四日	よっか	four days; fourth of the month	
厳しい	きびしい	strict; severe; intense	
御菓子	おかし	sweets; snacks	
林檎	りんご	apple	
女の子	おんなのこ	girl; daughter	
美味しい	おいしい	tasty	
卒業	そつぎょう	graduation	
新幹線	しんかんせん	Shinkansen; Bullet Train	
留学	りゅうがく	studying abroad	
航空便でお願いします	こうくうびんでおねがいします	Air mail, please	
其方	そちら	that place/way/person there	
便	びん	mail; flight	
案内	あんない	information; leading; to guide	
そうして	そうして	and; like that	
お湯が沸く	おゆがわく	water boils	
殆ど	ほとんど	almost; hardly	
お湯	おゆ	hot water	
頭がいい	あたまがいい	smart; clever	
お世話になる	おせわになる	receive favor; be indebted; be grateful	
賛成です	さんせいです	I agree	
自動車	じどうしゃ	automobile	
村	むら	village	
まっすぐ行く	まっすぐいく	go straight	
添削	てんさく	correction	
遠い	とおい	far; distant	
分かる	わかる	to understand	
乾杯	かんぱい	Cheers!; a toast	
季節	きせつ	season	
明ける	あける	to dawn; to grow light	
払う	はらう	to pay; to brush off; to dispose of	
趣味	しゅみ	hobby; interest	
読む	よむ	to read	
浮かぶ	うかぶ	float	
石	いし	stone; small rock	
植物	しょくぶつ	plant; vegetation	
貰う	もらう	receive	
東京	とうきょう	Tokyo	
ではお元気で	ではおげんきで	take care; be well; farewell	
売店	ばいてん	shop; stand	
散歩	さんぽ	walk; stroll	
梅雨明け	つゆあけ	end of the rainy season	
橋	はし	bridge	
お八つ	おやつ	snack; refreshment　(usually said by children)	
蜘蛛	くも	spider	
鳴る	なる	to sound; to ring; to roar	
申す	もうす	to be called; to say (humble)	
歩道橋	ほどうきょう	pedestrian bridge	
冗談でしょう	じょうだんでしょう	You must be kidding!	
電子メール	でんしメール	e-mail	
暑い	あつい	hot (weather); warm	
百五十円になります	ひゃくごじゅうえんになります	It will be 150 yen.	
波	なみ	wave; fluctuations	
駄目	だめ	useless; no good; hopeless; no	
風邪	かぜ	cold (sickness)	
確かに	たしかに	certainly; definitely	
お先に失礼します	おさきにしつれいします	excuse me for leaving early (used when leaving a workplace)	
入れる	いれる	to put in; to insert	
配る	くばる	hand out; distribute; allot	
～枚	～まい	counter for flat things (pieces of paper, shirts, coins, etc.)	
涼しい	すずしい	cool (weather); refreshing	
真面目	まじめ	serious; sober; earnest	
いろいろな所	いろいろなところ	various places	
休み	やすみ	rest; holiday; absence	
やばい	やばい	dangerous; risky; awful (young persons' slang); terrible; crap; amazing; cool	
太っています	ふとっています	is fat	
中学校	ちゅうがっこう	junior high school; middle school	
多分	たぶん	probably; perhaps	
開く	ひらく	to open (doors, business, eyes, etc.); to be open; be available; to be empty	
壊れる	こわれる	to be broken; to break	
呉れる	くれる	to give; to let one have; to do for one; to be given (from the receiver's point of view)	
締め切り	しめきり	cut-off; deadline; No Entrance	
差す	さす	to pour (drink); to raise (hands, umbrella)	
だいたい同じです	だいたいおなじです	More or less the same	
～時間	～じかん	... hours	
素敵	すてき	lovely; nice	
半	はん	half (usually suffix); odd number	
木の下	このした, このもと	under a tree	
船	ふね	ship; boat; vessel	
痩せる	やせる	to lose weight; to become thin	
皆	みんな	everybody; everything	
月	つき	moon; month	
危ない	あぶない	dangerous; uncertain	
教科書を閉じてください	きょうかしょをとじてください	Please shut the textbook	
文字	もじ	character; letter	
手伝う	てつだう	help; assist	
人力車	じんりきしゃ	rickshaw; jinrikisha	
見落とす	みおとす	miss; fail to notice	
現れる	あらわれる	to appear; to come in sight; to become visible; to come out; to materialize; to be expressed (e.g. emotions); to become apparent (e.g. trends, effects); to emerge	
作品	さくひん	work of art; piece	
君	くん	suffix for names of friends, subordinates, etc.	
偶に	たまに	occasionally; once in a while	
～度	～ど	degrees; times	
優しい	やさしい	gentle; kindhearted	
昼ご飯	ひるごはん	lunch	
事	こと	thing; matter; circumstances	
そんな事はない	そんなことはない	I don't think so.	
外国	がいこく	foreign country	
正午	しょうご	noon; noontime	
咲く	さく	to bloom	
思い出	おもいで	memory; recollections	
留守番電話	るすばんでんわ	answering machine	
雑誌	ざっし	magazine; journal	
捨てる	すてる	to throw away; to cast away; to dump; to discard; to abandon	
工場	こうじょう	factory; plant	
生活	せいかつ	life; living	
帰る	かえる	return (home); go back	
吸う	すう	inhale; suck	
厚い	あつい	thick; bulky; kind; cordial; shameless	
今日はこれで終わります	きょうはこれでおわります	That's all for today	
生まれる	うまれる	to be born	
ホワイトデー	ホワイトデー	White Day	
低い	ひくい	low (height, tone, rank, degree, cost, etc.);  short	
虹	にじ	rainbow	
姉	あね	older sister	
プロジェクト	プロジェクト	project	
特に	とくに	particularly; especially; specifically	
晴れ	はれ	fine weather; clear sky	
理由	りゆう	reason	
雨がやむ	あめがやむ	the rain stops	
申し訳ありません	もうしわけありません	You have my apologies.	
過ごす	すごす	pass/spend (time)	
航空便	こうくうびん	airmail	
往復切符	おうふくきっぷ	round-trip ticket; return ticket	
緑	みどり	green; foliage	
参った	まいった	I'm beaten; I give up	
道の右側	みちのみぎがわ	right side of the street	
紹介	しょうかい	introduction; presentation; referral; listing	
紅茶	こうちゃ	black tea	
捕まる	つかまる	be caught; be arrested	
角	かど	corner; edge; angle	
蝉	せみ	cicada; locust	
ごきぶり	ごきぶり	cockroach	
温い	ぬるい	tepid; lukewarm	
何度も	なんども	many times	
働く	はたらく	to work	
写真	しゃしん	photograph	
止まる	とまる	to stop; to come to a halt	
けち	けち	stingy; miser	
先ず	まず	first; first of all	
時計	とけい	clock; watch	
面白い	おもしろい	interesting; amusing	
とんでもない	とんでもない	unthinkable; outrageous	
見ているだけです	みているだけです	Just looking	
感じる	かんじる	to feel; to sense; to experience	
力	ちから	strength; power	
鷹	たか	falcon; hawk	
駱駝	らくだ	camel	
漫画	まんが	manga; comics	
土曜日	どようび	Saturday	
踊る	おどる	dance	
夕方	ゆうがた	evening; dusk	
絵	え	picture; painting; drawing	
ちょっと待って下さい	ちょっとまってください	Please wait a moment	
記念日	きねんび	holiday; anniversary	
誰か	だれか	someone	
長い	ながい	long	
一号車	いちごうしゃ	car number one	
間違い	まちがい	mistake; error	
死ぬ	しぬ	to die	
良い	いい, よい	good	
する価値があります	するかちがあります	worth doing	
怖い	こわい	scary, frightening, eerie, dreadful	
東京駅	とうきょうえき	Tokyo station	
どんな	どんな	what kind of ...	
出発時間	しゅっぱつじかん	starting (departure) time	
隣	となり	next to; neighboring house	
黒い	くろい	black	
二日酔い	ふつかよい	hangover	
壊す	こわす	to break; to destroy; to smash	
側	そば	near, close, beside, by the side of	
そっち	そっち	that place/way/person there (informal)	
空手	からて	karate; empty hand	
着く	つく	to arrive at; to reach	
捕まえる	つかまえる	to arrest; to catch; to seize	
急ぐ	いそぐ	to hurry; hasten	
初心者	しょしんしゃ	beginner	
曲がる	まがる	to bend; to turn; to curve	
辞書形	じしょけい	dictionary form	
一生懸命	いっしょうけんめい	with all one's might; with utmost effort; very hard	
後で	あとで	afterwards	
急	きゅう	urgent; dire; pressing	
奇麗	きれい	beautiful, pretty, neat	
背が高い	せがたかい	tall	
小野	おの	Ono (family name)	
冬休み	ふゆやすみ	winter vacation	
期末試験	きまつしけん	final exam	
広告	こうこく	public notice; advertisement	
不愉快	ふゆかい	unpleasant; disagreeable	
出席	しゅっせき	attendance; presence	
朝御飯	あさごはん	breakfast	
中学生	ちゅうがくせい	junior high school student	
洗う	あらう	to wash	
予約	よやく	reservation; appointment	
六才	ろくさい	six years old	
箱	はこ	box; case	
ジュース	ジュース	juice; soft drink	
下手	へた	not good at	
乗り換え	のりかえ	change; transfer	
先週	せんしゅう	last week	
番線	ばんせん	track number	
数学者	すうがくしゃ	mathematician	
問題	もんだい	problem; question	
テーブル	テーブル	table	
空	そら	sky; the heavens	
磨く	みがく	to polish; to shine; to brush (e.g. teeth)	
辛い	からい	spicy; salty; bitter; strict	
調子	ちょうし	tone; condition	
火	ひ	fire	
割る	わる	divide; crack; split	
洋服	ようふく	Western clothes	
門	もん	gate	
夫婦	ふうふ	husband and wife; married couple	
勉強になりました	べんきょうになりました	I learned a lot (thank you)	
丸	まる	circle or sphere; wholeness	
かまいません	かまいません	no problem; I don't mind	
パン粉	パンこ	bread crumbs	
閉まる	しまる	to be shut; to be closed	
音楽	おんがく	music	
住む	すむ	to live; reside	
公園	こうえん	park; public garden	
鷲	わし	eagle	
往復	おうふく	going and returning; round trip	
ホームシック	ホームシック	homesickness	
御母さん	おかあさん	mother	
冷たい	つめたい	cold (thing); unkind (person)	
蛇	へび	snake; serpent; hard drinker	
明日	あした, あす, みょうにち	tomorrow	
たばこを吸う	たばこをすう	smoke (cigarettes)	
百万	ひゃくまん	one million	
御飯	ごはん	cooked rice; meal	
話	はなし	talk; conversation; story	
増える	ふえる	to increase; to accrue	
注文	ちゅうもん	order; request	
掃除	そうじ	cleaning	
元気がない	げんきがない	don't look well	
門限	もんげん	closing time; lockup; curfew	
定価	ていか	fixed price	
博物館	はくぶつかん	museum	
幾ら	いくら	how much	
肴	さかな	appetizer or snack served with drinks; performance to liven up a bar	
近く	ちかく	near; close to; shortly; soon	
ご馳走	ごちそう	feast; treat; delicacies	
どちらかと言うと	どちらかというと	if pushed I'd say; if I had to say then	
今週	こんしゅう	this week	
座る	すわる	to sit; to squat; to assume (a position)	
～がる	～がる	to feel; to behave as if one were	
くしゃみが出ます	くしゃみがでます	I sneeze	
箸	はし	chopsticks	
混ぜる	まぜる	to mix; to stir; to blend	
野原	のはら	field; plain	
服	ふく	clothes	
～歳	～さい	years old	
北口	きたぐち	north entrance	
名詞	めいし	noun	
息子さん	むすこさん	son (respectful)	
金髪	きんぱつ	blond; blonde	
～と申します	～ともうします	my name is...	
二三日	にさんにち	two to three days	
失礼しました	しつれいしました	Excuse me; I am very sorry	
相変わらず	あいかわらず	as usual; as before; the same	
平日	へいじつ	weekday	
片仮名	かたかな	katakana	
主人	しゅじん	head of household; master; husband; shop owner	
苦手	にがて	poor (at); weak (in); not very good (at); dislike (of)	
～冊	～さつ	counter for books, volumes, etc.	
皮膚科	ひふか	dermatology	
戴きます	いただきます	expression of gratitude before meals	
大学院生	だいがくいんせい	graduate student	
併し	しかし	however; but	
消防士	しょうぼうし	firefighter	
疲れる	つかれる	get tired; become fatigued	
如何	いかが	how; what	
蟷螂	かまきり	praying mantis	
干物	ひもの	dried food; dried fish	
皆さん	みなさん	everybody; ladies and gentlemen	
確か	たしか	certain; sure; definite; if I remember correctly	
勉強	べんきょう	study	
照る	てる	shine; be fine	
小包	こづつみ	parcel; package	
願う	ねがう	to wish; to ask a favor; to apply for	
大使館	たいしかん	embassy	
照り焼き	てりやき	teriyaki (meat or fish marinated in sweet soy sauce and broiled)	
果物	くだもの	fruit	
同じ	おなじ	same; identical	
動く	うごく	to move	
一昔	ひとむかし	ages; long time; decade; the past ten years	
言葉	ことば	word; language	
歌舞伎	かぶき	kabuki; Japanese classical play	
何故	なぜ	why; for what reason	
起きる	おきる	get up; get out of bed; occur (event)	
交番	こうばん	police box	
式場	しきじょう	ceremonial hall; place of ceremony (e.g. marriage)	
親切	しんせつ	kind; friendly	
そろそろ失礼します	そろそろしつれいします	It's almost time to leave now.	
冗談	じょうだん	joke	
到着時刻	とうちゃくじこく	arrival time	
出す	だす	to take out; to get out; to send (e.g. letter); to hand in	
実は	じつは	as a matter of fact; frankly	
御休みなさい	おやすみなさい	good night	
暖かい	あたたかい	warm	
八万	はちまん, やよろず	eighty thousand; many	
色々	いろいろ	various	
下	した	under; below	
左に曲がる	ひだりにまがる	to turn to the left	
切符売り場	きっぷうりば	ticket window; box office; ticket	
大嫌い	だいきらい	hate	
と言うか	というか	or perhaps I should say; or, how should I put it,....	
終電	しゅうでん	last train	
えびフライ	えびフライ	shrimp, breaded and deep-fried	
降る	ふる	fall (i.e. rain/snow); come down; precipitate	
金色	きんいろ	golden color	
地図	ちず	map; atlas	
此方	こちら	this place/way/person here	
こちらこそ	こちらこそ	It is I who should say so; Thank you	
中止	ちゅうし	suspension, stoppage, discontinuance, interruption	
汚れる	よごれる	to become dirty	
身長	しんちょう	stature; height	
どうぞ	どうぞ	please; ok; Here it is	
込む	こむ	to be crowded; to be congested	
蝶	ちょう	butterfly	
プレゼント	プレゼント	present; gift	
字	じ	character; letter	
おじさん	おじさん	uncle; mister	
ペン	ペン	pen	
留守番	るすばん	caretaking; caretaker	
減る	へる	to decrease (in size or number); to diminish; to abate	
羊	ひつじ	sheep	
分野	ぶんや	field; sphere	
今月	こんげつ	this month	
単語	たんご	word; vocabulary; (usually) single character word	
野菜	やさい	vegetable	
お客さん	おきゃくさん	guest; client; customer (honorific)	
風呂	ふろ	bath	
風邪薬	かぜぐすり	remedy for a cold	
狸	たぬき	raccoon dog; sly person	
女	おんな	woman; girl	
大変	たいへん	very; hard; awful; serious	
耳	みみ	ear	
平仮名	ひらがな	hiragana	
床屋	とこや	barber; barbershop	
連絡する	れんらくする	to contact	
見る	みる	to see; to look; to try	
聞く	きく	to hear; to listen; to ask	
昼御飯	ひるごはん	lunch	
吹く	ふく	blow; play on a wind instrument	
六分	ろっぷん	six minutes	
九百	きゅうひゃく	nine hundred	
～なんです	～なんです	it is assuredly that ...; can say with confidence that	
美しい	うつくしい	beautiful	
留学生	りゅうがくせい	overseas student; exchange student	
赤	あか	red; crimson	
分	ぶん	amount; part; share	
二才	にさい	two years old	
熱い	あつい	hot (objects)	
十七日	じゅうしちにち	the seventeenth (day)	
暗い	くらい	dark; dreary; shadowy	
いらっしゃい	いらっしゃい	Please come in!; Welcome!	
電話	でんわ	telephone; phone call	
お弁当	おべんとう	bento; boxed lunch (honorific)	
丈夫	じょうぶ	healthy; robust; strong; durable	
背中	せなか	back (of body)	
店	みせ	shop; store	
車	くるま	car	
泥	どろ	mud	
行	ぎょう	line (i.e. text); row	
二週間前	にしゅうかんまえ	two weeks ago	
雨が降る	あめがふる	to rain	
主に	おもに	mainly; mostly	
丁度	ちょうど	exactly; precisely; just	
守る	まもる	to protect; to observe; to abide (by the rules)	
何	なに,なん	what; which; how many	
肉	にく	flesh; meat	
花	はな	flower; blossom	
並べる	ならべる	line up; display; set up	
探す	さがす	search for; look for	
鳴く	なく	cry; chirp; meow	
宝くじに当たる	たからくじにあたる	win the lottery	
毎週	まいしゅう	every week	
宝くじ	たからくじ	lottery	
結婚式	けっこんしき	wedding ceremony	
数える	かぞえる	to count; to calculate	
喜んで	よろこんで	gladly; with pleasure	
本当	ほんとう	truth; reality	
営業	えいぎょう	business; sales	
朝ご飯	あさごはん	breakfast	
風邪をひく	かぜをひく	catch a cold	
考える	かんがえる	to consider; to think about	
掛ける	かける	to hang; to expend (time, money)	
ゴールデンウィーク	ゴールデンウィーク	golden week (holiday period in early May)	
新聞	しんぶん	newspaper	
約束を守る	やくそくをまもる	keep a promise	
七	なな,しち	seven	
例	れい	example; precedent	
消える	きえる	to vanish; to disappear	
おかえり	おかえり	return; (abbr) welcome home	
漢字	かんじ	Chinese characters; kanji	
此処	ここ	here	
作る	つくる	to make; to create	
薄い	うすい	thin; weak; pale	
下ろす	おろす	bring down; take down; pull down; withdraw (money)	
木の葉	このは	tree leaves	
水曜日	すいようび	Wednesday	
玩具	おもちゃ,がんぐ	toy; plaything	
消す	けす	to turn off; erase; delete; put out	
お休みなさい	おやすみなさい	good night	
然し	しかし	however; but	
付ける	つける	to attach; set; apply; switch on; write (a diary)	
おかえりなさい	おかえりなさい	Welcome back; Welcome home.	
葉書	はがき	postcard	
ただいま	ただいま	I'm back!; just now; presently	
どれ	どれ	which? (between three or more choices)	
包む	つつむ	wrap; pack	
大学	だいがく	university; college	
虫歯	むしば	decayed tooth; cavity	
味方	みかた	friend; ally; supporter	
十一日	じゅういちにち	the eleventh (day)	
御願いします	おねがいします	please	
貴方	あなた	you	
道に迷う	みちにまよう	become lost; lose one's way	
～点	～てん	counter for points (on a test)	
質問	しつもん	question	
押す	おす	to push; to press	
川	かわ	river; stream	
銀河	ぎんが	Milky Way; galaxy	
無事	ぶじ	safely; peacefully	
御蔭で	おかげで	thanks to (you)	
片道切符	かたみちきっぷ	one-way ticket	
花瓶	かびん	flower vase	
どうも	どうも	very; thanks; somehow	
男性	だんせい	male; man	
～ヶ月	～かげつ	counter for months (period of time)	
コピーする	コピーする	to copy; to photocopy	
酔っ払う	よっぱらう	get drunk	
描く	かく	to draw; to paint; to sketch	
内科	ないか	internal medicine	
訳す	やくす	to translate; to interpret	
後ろ	うしろ	back; behind	
届く	とどく	to reach; to be received	
台風	たいふう	typhoon	
朝飯	あさめし, あさはん	breakfast	
並ぶ	ならぶ	line up; be parallel	
全然	ぜんぜん	wholly; not at all (with negative)	
広い	ひろい	wide; spacious	
大家	おおや	landlord	
白い	しろい	white	
他	た,ほか	other; other things	
聞こえる	きこえる	to be heard; to be audible	
最低	さいてい	least; lowest; disgusting; yuck!	
妻	つま	wife	
残業	ざんぎょう	overtime	
残る	のこる	to remain; to be left over	
最近	さいきん	lately; recently	
この間	このあいだ	the other day; recently	
方言	ほうげん	dialect	
いってきます	いってきます	I'm off, see you later	
五日	いつか	five days; fifth of the month	
心温まる	こころあたたまる	to be heart-warming	
歌手	かしゅ	singer	
シーディー	シーディー	CD	
同感です	どうかんです	I agree	
御風呂	おふろ	bath	
引く	ひく	to draw; to pull	
電車	でんしゃ	(electric) train	
女性	じょせい	woman; female	
部屋	へや	room	
又	また	again; also; or	
饅頭	まんじゅう	steamed yeast bun with filling	
さあ	さあ	now then; well; oh	
杯	はい	sake cup; cup for alcoholic beverages; counter for cupfuls	
茶店	ちゃみせ	stall that sells tea and candy	
虎猫	とらねこ	tabby cat	
五時	ごじ	five o'clock	
御馳走様でした	ごちそうさまでした	said after one has been treated (i.e. after a meal)	
ざんねんですね	ざんねんですね	That's too bad.	
楽器	がっき	musical instrument	
両親	りょうしん	parents	
可能性	かのうせい	potentiality; likelihood; possibility; availability	
零	れい	zero	
十三	じゅうさん	thirteen	
御姉さん	おねえさん	older sister	
含まれる	ふくまれる	be included (in something)	
百円	ひゃくえん	100 yen	
専門	せんもん	specialty; subject of study	
警官	けいかん	police officer; policeman	
八百屋	やおや	vegetable store; greengrocer	
ボーナス	ボーナス	bonus	
張る	はる	to stick; to paste; to strain; to tighten; to form (i.e. ice on pond); to attach a web link	
どうやら	どうやら	it seems like; it appears that; somehow or another	
ご免下さい	ごめんください	may I come in?	
貝	かい	shell; shellfish	
御手洗い	おてあらい	toilet; bathroom	
置く	おく	put; leave	
本当ですか	ほんとうですか	Really?	
紫	むらさき	purple	
今学期	こんがっき	this semester	
去年	きょねん	last year (spoken language)	
飲む	のむ	to drink; take (medicine)	
警察	けいさつ	police	
転ぶ	ころぶ	to fall down; to fall over	
お母さん	おかあさん	mother (honorific)	
知り合う	しりあう	get acquainted with	
お大事に	おだいじに	take care of yourself	
兎	ウサギ	rabbit; hare	
お願いします	おねがいします	please	
ラジカセ	ラジカセ	tape recorder with a radio	
意見	いけん	opinion	
三つ	みっつ	three (things)	
昨年	さくねん	last year　(written language)	
じろじろ見る	じろじろみる	stare	
宿題を出してください	しゅくだいをだしてください	Please hand in your homework	
丸い	まるい	round	
御茶	おちゃ	tea	
大丈夫	だいじょうぶ	alright; OK; no problem	
余り	あまり	not very (with negative); remainder; leftover; too much (with positive)	
歴史	れきし	history	
油	あぶら	oil	
牛乳	ぎゅうにゅう	(cow) milk	
強い	つよい	strong	
勤める	つとめる	to work (for); to be employed; to serve (as)	
こおろぎ	こおろぎ	cricket	
掛る	かかる	to take; to hang; to come into view; to arrive; to start (engines, motors)	
実る	みのる	bear fruit; ripen	
麒麟	きりん	giraffe; qilin (Chinese unicorn); Kirin (brand of beer)	
歩く	あるく	to walk; go on foot	
苗	なえ	seedling	
夕べ	ゆうべ	evening; last night	
となりの人に聞いてください	となりのひとにきいてください	Please ask your neighbor	
午前中	ごぜんちゅう	in the morning	
建物	たてもの	building; structure	
再来月	さらいげつ	the month after next	
本棚	ほんだな	bookshelf	
山羊	やぎ	goat	
逃げる	にげる	to escape; to run away	
鼠	ねずみ	rat; mouse	
昔々	むかしむかし	once upon a time; a long time ago	
一昨日	おととい, いっさくじつ	the day before yesterday	
水	みず	water	
海外旅行	かいがいりょこう	trip to a foreign country	
沢山	たくさん	a lot; plenty	
亀	かめ	turtle; tortoise	
がり	がり	sliced ginger prepared in vinegar (served with sushi); pickled ginger	
聞いたことがあります	きいたことがあります	I've heard that	
泣く	なく	to cry; to weep	
成る程	なるほど	I see; really	
柴犬	しばいぬ	Shiba Inu (breed of dog)	
ちょっと	ちょっと	just a moment; just a little; it's a bit (difficult)	
漫画家	まんがか	cartoonist; manga artist	
矢張り	やはり,やっぱり	as expected; also; still	
キャンプ	キャンプ	camping; camp	
窓	まど	window; windowpane	
豚	ぶた	pig	
ラーメン	ラーメン	ramen (Chinese noodles)	
頼む	たのむ	to request; to ask	
起こす	おこす	to cause; to wake someone	
練習	れんしゅう	practice	
晩	ばん	evening; counter for nights	
お返し	おかえし	return favor; return gift	
背広	せびろ	business suit	
金	かね	money; metal	
温泉	おんせん	hot spring	
数字	すうじ	numeral; figure; digit; numeric character	
二か月前	にかげつまえ	two months ago	
スピーチ	スピーチ	speech	
この頃	このごろ	now; these days; recently	
弟	おとうと	younger brother	
窓口	まどぐち	teller or ticket window; counter	
場合	ばあい	case; situation	
六百	ろっぴゃく	six hundred	
君	きみ,くん	you; name suffix for boys	
奥さん	おくさん	(someone else's) wife; married lady	
楽しい	たのしい	enjoyable; fun	
アレルギー	アレルギー	allergy	
酒	さけ	sake; alcoholic drink	
お皿	おさら	plate; dish	
友達	ともだち	friend; companion	
試す	ためす	to attempt; to test	
先	さき	ahead; first; previous; before	
汁物	しるもの	soup	
会議室	かいぎしつ	meeting room; conference room	
歯	は	tooth	
ガソリン	ガソリン	gasoline	
それまで	それまで	until then; up until then	
返す	かえす	to return (something); to repay	
七時	しちじ	seven o’clock	
池	いけ	pond	
連れてくる	つれてくる	bring (someone) along	
人類学	じんるいがく	anthropology	
迷う	まよう	to lose one's way; to hesitate; to be of two minds over; to be puzzled	
予定	よてい	plan; schedule	
鮪	まぐろ	tuna	
中国	ちゅうごく	China	
鉛筆	えんぴつ	pencil	
九日	ここのか	nine days; ninth of the month	
おはようございます	おはようございます	Good morning.; Hello.	
六日	むいか	six days; sixth of the month	
先生	せんせい	teacher; term of address for teacher, doctor, lawyer, writer etc.	
定期券	ていきけん	commuter's pass	
涙	なみだ	tears (e.g. from crying)	
法	ほう	law; rule	
落ちる	おちる	to fall; to drop; to fail (e.g. exam)	
お姉さん	おねえさん	older sister (honorific)	
生徒	せいと	pupil; student	
持っていく	もっていく	take (something) along	
似合う	にあう	to suit; to match well	
ルームメート	ルームメート	roommate	
軽い	かるい	light (not heavy)	
明後日	あさって,みょうごにち	day after tomorrow	
運動	うんどう	motion; exercise	
手紙	てがみ	letter	
凄い	すごい	wonderful; great; incredible	
よろしくお願いします	よろしくおねがいします	I look forward to working with you; Thank you in advance; Please treat me well	
ハンカチ	ハンカチ	handkerchief	
銀色	ぎんいろ	silver (color)	
掛かる	かかる	hang; take, require, cost (e.g. a resource); put on (glasses); lock (door); attend, deal with (vi)	
親	おや	parent(s)	
火曜日	かようび	Tuesday	
穴熊	あなぐま	badger	
三分	さんぷん	three minutes	
白鳥	はくちょう	swan	
灰皿	はいざら	ashtray	
喉	のど	throat	
外国語	がいこくご	foreign language	
～分	～ふん	minutes	
に就て	について	concerning; along; under; per	
再来年	さらいねん	the year after next	
雉	きじ	green pheasant (Japan's national bird)	
科学	かがく	science	
者	もの	person; fellow	
説明	せつめい	explanation; description	
森	もり	forest; thick woods	
何処	どこ	where	
どうやって	どうやって	how; by what means	
一人	ひとり	one; one person	
十二	じゅうに	twelve	
夕飯	ゆうはん	evening meal; supper	
近づく	ちかづく	to approach; draw near; get closer to	
ちょっと違います	ちょっとちがいます	Slightly different	
お世話になりました	おせわになりました	Thank you for your help/kindness.	
二十三日	にじゅうさんにち	the twenty-third (day)	
プロポーズ	プロポーズ	marriage proposal; propose	
曜	ヨウ	day of the week	
頃	ころ, ごろ	time; at about	
ファイル	ファイル	file	
間違う	まちがう	be mistaken; be incorrect	
何方	どなた	who; which way; which one	
雨	あめ	rain	
終電車	しゅうでんしゃ	last train	
年	とし	year; age	
蒲公英	たんぽぽ	dandelion	
布団	ふとん	futon; bedquilt	
恥ずかしい	はずかしい	shy; ashamed; embarassed	
今日	きょう	today	
見せる	みせる	to show; to display	
出掛ける	でかける	go out; be about to go out	
ピンク	ピンク	pink	
ご馳走様でした	ごちそうさまでした	said after meals	
秋	あき	autumn; fall	
豚カツ	とんカツ	pork cutlet	
一才	いっさい	one-year-old	
十	じゅう	ten	
大切	たいせつ	important; valuable	
ええ	ええ	yes; that is correct; well	
までに	までに	by (time/date)	
あそこ	あそこ	over there	
崖	がけ	cliff	
遅い	おそい	slow; late	
お兄さん	おにいさん	older brother (honorific)	
八	はち	eight	
日本猿	にほんざる	snow monkey	
一瞬	いっしゅん	instant; moment	
ベッド	ベッド	bed	
進む	すすむ	to advance; move forward	
四角い	しかくい	square; four-sided	
カレーライス	カレーライス	curried rice	
仕事	しごと	work; job	
二日酔	ふつかよい	hangover	
ううん	ううん	uh-uh; no	
技術者	ぎじゅつしゃ	engineer; technical expert	
何時	なんじ	what time?	
～か月	～かげつ	months (duration)	
後	あと	after; back; behind; more (minutes, points); the rest	
持てる	もてる	be popular (with)	
誰	だれ	who; whom	
絶対	ぜったい	absolute; absolutely	
御馳走様	ごちそうさま	word used after one has been treated	
どうもありがとうございました	どうもありがとうございました	Thank you (very much)	
水色	みずいろ	sky blue; turquoise	
辺	へん	vicinity; part	
南口	みなみぐち	south entrance	
御～	お～,ご～	honorable; honorific	
病院	びょういん	hospital	
一番	いちばん	most; best	
ぶらぶら	ぶらぶら	wander aimlessly; hang about	
社長	しゃちょう	president (of a company)	
駅員	えきいん	station employee	
結婚	けっこん	marriage; get married	
二十九日	にじゅうくにち	the twenty-ninth (day)	
十六分	じゅうろっぷん	sixteen minutes	
～回	～かい	~times (counter)	
十一	じゅういち	eleven	
十時	じゅうじ	ten o'clock	
神社	じんじゃ	Shinto shrine	
もう一度	もういちど	one more time	
晩御飯	ばんごはん	dinner	
一緒に	いっしょに	together	
違います	ちがいます	different; wrong	
シャワー	シャワー	shower	
洗濯	せんたく	laundering; washing	
～年代	～ねんだい	~ties (as in "the sixties")	
コップ	コップ	cup; glass	
左	ひだり	left	
父親	ちちおや	father	
椅子	いす	chair	
うまい	うまい	good; skillful; clever	
声	こえ	voice	
迎え	むかえ	greeting; meeting	
多い	おおい	many; numerous	
一度	いちど	once	
兄弟	きょうだい	sibling(s)	
試合	しあい	match; game	
自転車	じてんしゃ	bicycle	
グラム	グラム	gram	
笑う	わらう	to laugh; to smile	
九分	くぶん,きゅうふん	nine minutes	
郵便局	ゆうびんきょく	post office	
お菓子	おかし	confections; sweets; candy	
字引	じびき	dictionary	
其れでは	それでは	if that is the case; well then	
バス	バス	bus	
土	つち	earth; soil; ground	
安い	やすい	inexpensive; cheap	
まあね	まあね	well, I must admit ...	
履く	はく	to wear (on lower body); to put on	
ウェイター	ウェイター	waiter	
直す	なおす	to repair; to heal; to fix; to replace	
昨日	きのう, さくじつ	yesterday	
そうかもしれません	そうかもしれません	That is probably so.	
エアコン	エアコン	air-conditioning; air conditioner	
戸	と	door (esp. Japanese-style)	
薬	くすり	medicine; drug; remedy; chemical	
十分	じゅっぷん	ten minutes	
閉じる	とじる	to close; to shut	
自分	じぶん	self; oneself	
靴	くつ	shoes; boots	
過ぎ	すぎ	past; after; too (much)	
お先にどうぞ	おさきにどうぞ	go ahead	
ディーブイディー	ディーブイディー	DVD	
もう少し	もうすこし	a little more	
急に	きゅうに	swiftly; suddenly; abruptly	
幾つ	いくつ	how many; how old	
出る	でる	exit; leave; go out	
天気予報	てんきよほう	weather forecast	
今晩は	こんばんは	good evening	
気	き	spirit; temperament	
薔薇	バラ	rose	
ポップコーン	ポップコーン	popcorn	
命	いのち	life	
～匹	～ひき	counter for small animals (cats, insects, etc.)	
今年	ことし	this year	
皆	みんな,みな	all; everybody	
神	かみ	god; spirit	
目	め	eye	
青い	あおい	blue	
町	まち	town; block; city quarter	
～月	～がつ	suffix for months	
円	えん	circle; Yen	
山	やま	mountain	
口	くち	mouth; opening	
机	つくえ	desk; table	
無い	ない	to not be	
有名人	ゆうめいじん	celebrity	
あの	あの	that (thing) over there; um…	
八つ	やっつ	eight (things)	
時間のたつ	じかんのたつ	passage of time; perceived time; relative time	
二十八日	にじゅうはちにち	the twenty-eighth (day)	
近い	ちかい	near; close; short (distance)	
また	また	again	
足る	たる	be sufficient; be enough	
いらっしゃる	いらっしゃる	come; go (honorific)	
保険	ほけん	insurance	
レントゲン	レントゲン	X-rays	
待つ	まつ	wait; wait for	
昔	むかし	(in the) old times; the old days	
いい考えですね	いいかんがえですね	That's a good idea!	
赤い	あかい	red	
ホストファミリー	ホストファミリー	host family	
ごみ	ごみ	rubbish; trash	
名前	なまえ	name	
～個	～こ	counter for smaller items	
連れていく	つれていく	to take (someone) along	
十四分	じゅうよんぷん	fourteen minutes	
バレンタインデー	バレンタインデー	St. Valentine's Day	
番	ばん	one's turn; watch; number ... (in a series)	
気をつける	きをつける	be cautious/careful	
高校	こうこう	high school	
船便	ふなびん	surface mail; shipping service	
ゆっくりと	ゆっくりと	slowly; at ease	
鶴	ツル	crane; stork	
八才	はっさい	eight years old	
来月	らいげつ	next month	
そして	そして	and; and then; thus; and now	
道の左側	みちのひだりがわ	left side of the street	
おねがいします	おねがいします	please	
来週	らいしゅう	next week	
自動車学校	じどうしゃがっこう	driving school	
前	まえ	front; before	
飛ぶ	とぶ	fly; leap; jump	
暇	ひま	free time; spare time; time off	
から	から	because; from	
いいえどういたしまして	いいえどういたしまして	You are welcome; Don't mention it	
二時半	にじはん	two thirty (in the morning/afternoon)	
先月	せんげつ	last month	
可笑しい	おかしい	funny; amusing; strange; peculiar	
また明日	またあした	See you tomorrow.	
焼肉	やきにく	yakiniku (Japanese dish of fried meat), Korean barbecue	
文法	ぶんぽう	grammar	
十二時	じゅうにじ	twelve o'clock	
閉める	しめる	to close; to shut	
文	ぶん	sentence; text	
行ってらっしゃい	いってらっしゃい	have a good day; take care; see you	
作家	さっか	writer; novelist	
御免なさい	ごめんなさい	I'm sorry.	
不合格	ふごうかく	failure; disqualification	
韓国料理	かんこくりょうり	Korean food	
光	ひかり	light; flash	
山川さん	やまかわさん	Mr./Mrs Yamakawa	
歩いて	あるいて	on foot	
新しい	あたらしい	new	
入り口	いりぐち	entrance	
思い出す	おもいだす	to recall; to recollect	
達	たち	plural marker for some words	
少々	しょうしょう	a little; a few	
だめです	だめです	That's wrong.; That's not OK.	
別々	べつべつ	separately	
結婚する	けっこんする	to marry	
足	あし	leg; foot	
折り紙	おりがみ	origami; paper folding	
西	にし	west	
ご飯	ごはん	rice; food; meal	
コーヒー	コーヒー	coffee	
ほとんど	ほとんど	mostly; practically; nearly	
行く	いく, ゆく	to go	
魚	さかな,うお	fish	
～日	～にち	days (duration); specific day	
砂	すな	sand; grit	
様	さま	-sama; dear (suffix after the addressee of a letter)	
韓国	かんこく	Korea; South Korea	
すみません	すみません	excuse me	
枝	えだ	branch; twig	
嫌い	きらい	hate; dislike	
五十	ごじゅう	fifty	
右に曲がる	みぎにまがる	turn right	
数ヶ月	すうかげつ	several months	
傘	かさ	umbrella; parasol	
海	うみ	sea; ocean	
これまで	これまで	until now	
秋田犬	あきたいぬ	Akita (breed of dog)	
雪	ゆき	snow; snowfall	
猫	ねこ	cat	
兄	あに	older brother	
一月	ひとつき	one month	
為る	する	do; make; wear small items	
動物	どうぶつ	animal	
早く	はやく	early; soon	
九つ	ここのつ	nine (things)	
始める	はじめる	to start; to begin; to commence	
決まる	きまる	be decided; to be settled; to look good in clothes	
六時	ろくじ	six o'clock	
本当に	ほんとうに	really; truly; indeed	
お元気で	おげんきで	take care; be well; farewell	
忙しい	いそがしい	busy; occupied	
おばさん	おばさん	aunt	
八分	はっぷん,はちふん	eight minutes	
フィルム	フィルム	film	
家庭	かてい	family; household; home	
出口	でぐち	exit; exit ramp	
いちばん後ろ	いちばんうしろ	last car; tail end	
卒業式	そつぎょうしき	graduation ceremony	
一日中	いちにちじゅう	all day long	
あちら	あちら	that place/way/person over there	
道	みち	road; street	
金曜日	きんようび	Friday	
元気	げんき	healthy; energetic	
何時までも	いつまでも	forever	
大学院	だいがくいん	graduate school	
京子	きょうこ	Kyoko (female name)	
鶏	にわとり	(domestic) chicken	
入る	はいる	to enter	
八時	はちじ	eight o'clock	
どうして	どうして	why	
恥ずかしがり屋	はずかしがりや	shy person	
肉じゃが	にくじゃが	meat and potato stew	
何時も	いつも	always	
十六日	じゅうろくにち	the sixteenth (day)	
パンツ	パンツ	pants; underpants	
シャワーを浴びる	シャワーをあびる	take a shower	
四	よん,し	four	
十四日	じゅうよっか	fourteen days; fourteenth of the month	
四時	よじ	four o’clock	
二十歳	はたち, にじゅうさい	20 years old	
女の人	おんなのひと	woman	
毎朝	まいあさ	every morning	
少し	すこし	a bit; small quantity	
島	しま	island; isle	
背	せい	height; stature	
上手	じょうず	good at; skilled	
お風呂に入る	おふろにはいる	take a bath	
気持ち	きもち	"feeling; sensation; mood
preparedness; readiness; attitude
thanks; solicitude; sympathy
just a little; somewhat; slightly"	
事実	じじつ	fact; truth	
シルバー	シルバー	silver	
ご免なさい	ごめんなさい	I am sorry	
天ぷら	てんぷら	tempura	
お巡りさん	おまわりさん	policeman	
教える	おしえる	"to teach; to instruct
to tell; to inform
to preach"	
天	てん	sky; Heaven	
有名	ゆうめい	famous	
動詞	どうし	verb	
地震学	じしんがく	seismology	
来ない	こない	don't/doesn't come	
～について	～について	about...; concerning...	
十六	じゅうろく	sixteen	
八十	はちじゅう	eighty	
四月	しがつ	April	
馬鹿	ばか	fool; nonsense	
いくらですか	いくらですか	how much is this?	
二時	にじ	two o'clock	
火山	かざん	volcano	
自然	しぜん	nature, spontaneity	
コンタクト	コンタクト	contact lenses	
食事	しょくじ	meal	
お客様	おきゃくさま	customer; guest	
無理	むり	impossible; forced; overdoing	
東口	ひがしぐち	east exit/entrance	
バイオリン	バイオリン	violin	
六十	ろくじゅう	sixty	
マイナス	マイナス	minus; below zero	
お風呂	おふろ	bath	
白	しろ	white	
冬	ふゆ	winter	
マンション	マンション	apartment; apartment block; condominium	
嫌う	きらう	to dislike	
午後	ごご	afternoon; p.m.	
ぐうぜんですね	ぐうぜんですね	What a coincidence (seeing you here)	
曇り	くもり	cloudiness; cloudy weather	
アルバイト	アルバイト	casual job; student job; part-time job	
マフラー	マフラー	scarf; muffler	
何時から	いつから	since when; from when; how long	
休む	やすむ	to take a day off; take a break; to be absent	
休みの日	やすみのひ	A day off, holiday	
週	しゅう	week	
ノート	ノート	note book; laptop	
切符	きっぷ	ticket	
一時間	いちじかん	one hour	
ドア	ドア	door (Western style)	
七才	ななさい	seven years old	
良かったら	よかったら	if you like	
木の実	きのみ, このみ	nut; fruit; berry	
二日	ふつか	two days; second of the month	
此れ	これ	this	
ほかに	ほかに	other than; besides	
日	ひ	sun; sunlight; day	
赤ちゃん	あかちゃん	baby, infant	
行う	おこなう	do; carry out	
今	いま	now	
言語	げんご	language; speech	
時間	じかん	time; hour(s)	
上	うえ	up; above; top; on	
どういたしまして	どういたしまして	You are welcome.	
卵焼き	たまごやき	fried eggs; omelet; omelette	
林	はやし	woods; grove; thicket	
もうすぐ	もうすぐ	very soon; in a bit	
違い	ちがい	difference; discrepancy	
御酒	おさけ	alcohol; sake	
人	じん	suffix for nationalities	
歌詞	かし	song lyrics	
二百	にひゃく	two hundred	
ずっと	ずっと	continuously in some state (for a long time, distance); throughout; the whole time	
バター	バター	butter	
三時半	さんじはん	3:30	
一人で	ひとりで	by oneself; alone	
十一時	じゅういちじ	eleven o'clock	
一年生	いちねんせい	freshman; first-year student	
ずつ	ずつ	each; once per	
昨日の夜	きのうのよる	last night	
薬を飲む	くすりをのむ	take medicine	
隹	ふるとり	kanji "old bird" radical	
ホームステイ	ホームステイ	homestay	
学校	がっこう	school	
まで	まで	to (a place); as far as (a place); till (a time)	
十九分	じゅうきゅうふん	nineteen minutes	
出かける	でかける	go out; leave (the house)	
カレンダー	カレンダー	calendar	
七分	しちぶん,ななふん	seven minutes	
会う	あう	to meet	
馬	うま	horse	
にも	にも	also; too; not ... either; as well; even	
好き	すき	liking; fondness; love	
～屋	～や	...shop	
お日様	おひさま	sun (polite)	
十八	じゅうはち	eighteen	
行き	いき, ゆき	going	
今晩	こんばん	this evening; tonight	
お正月	おしょうがつ	New Year's Day	
テレビ	テレビ	television	
集める	あつめる	to collect; to gather	
天気	てんき	weather	
十八分	じゅうはっぷん,じゅうはちふん	eighteen minutes	
ああ	ああ	oh; that kind of...	
田中さん	たなかさん	Mr./Ms. Tanaka	
映画	えいが	movie	
そうか	そうか	I see; is that so (generally rhetorical); oh yeah; oh right	
右	みぎ	right	
国	くに	country	
八千	はっせん	eight thousand	
～方	～かた	how to...; way of...	
渡す	わたす	to carry across; to hand over	
ゆっくり言って下さい	ゆっくりいってください	Please say it slowly	
映画館	えいがかん	movie theater; cinema	
遅れる	おくれる	to be late	
一分	いっぷん	one minute	
七十	ななじゅう	seventy	
三時	さんじ	three o'clock	
二十五歳	にじゅうごさい	25 years old	
マッチ	マッチ	match; matchbox	
医者	いしゃ	doctor	
万	まん	ten thousand	
九	きゅう,く	nine	
何日ぐらいかかりますか	なんにちぐらいかかりますか	How many days will it take?	
だけ	だけ	only; just; merely; simply; no more than; nothing but	
七日	なのか	seven days; seventh of the month	
聞いて下さい	きいてください	Please listen.	
カップ	カップ	cup	
～過ぎ	～すぎ	past; after; over (e.g. eating)	
銀行	ぎんこう	bank	
スカート	スカート	skirt	
デート	デート	date (with a person)	
犬	いぬ	dog	
だから	だから	so; therefore	
見つける	みつける	to find (by looking); to discover; to locate; to come across; to detect; to spot	
虫	むし	insect; worm	
家	いえ, うち	house; home	
どうですか	どうですか	How about...?; How is...?	
四万	よんまん	forty thousand	
お父さん	おとうさん	father (honorific)	
私たち	わたしたち, わたくしたち	we	
やせています	やせています	to be thin	
段々	だんだん	gradually; one after another	
やめてください	やめてください	Please stop	
ワイシャツ	ワイシャツ	(business) shirt; (white) shirt	
走る	はしる	to run	
もう	もう	already; anymore; other; more	
旅行会社	りょこうがいしゃ	travel agency	
日本人	にほんじん	Japanese person	
二十	にじゅう	twenty	
四千	よんせん	four thousand	
まだ	まだ	still; (not) yet; as yet	
十五分	じゅうごふん	fifteen minutes	
十一分	じゅういっぷん	eleven minutes	
いちばん前	いちばんまえ	first car; front end	
小さい	ちいさい	small; little; tiny	
焼きそば	やきそば	pan-fried noodles	
五十円切手を三枚ください	ごじゅうえんきってをさんまいください	Give me three 50-yen stamps, please.	
毎月	まいつき, まいげつ	every month	
立つ	たつ	to stand; to rise	
動物園	どうぶつえん	zoo	
ありがとうございます	ありがとうございます	thank you (formal)	
～時	～とき	when...	
学	がく	learning; studies; science	
二つ	ふたつ	two (things)	
しょう油	しょうゆ	soy sauce	
サラリーマン	サラリーマン	office worker; salaried worker; company employee	
タオル	タオル	towel	
アイスクリーム	アイスクリーム	ice cream	
色	いろ	color	
少ない	すくない	few; little; scarce	
一つ	ひとつ	one (thing)	
七百	ななひゃく, しちひゃく	seven hundred	
そう	そう	in such manner; that way	
大丈夫ですか	だいじょうぶですか	Are you okay?	
一月	いちがつ	January	
～中	～ちゅう	in the center; in the middle	
二十七日	にじゅうしちにち	the twenty-seventh (day)	
二時間	にじかん	two hours	
ピアノ	ピアノ	piano	
お名前は	おなまえは	What's your name?	
迎えに来る	むかえにくる	come to pick someone up	
ご免	ごめん	sorry	
ビデオ	ビデオ	video	
トマト	トマト	tomato	
別	べつ	another; different	
十七	じゅうなな,じゅうしち	seventeen	
デパート	デパート	department store; department	
十日	とおか	ten days; tenth of the month	
まあまあ	まあまあ	OK; not bad; so-so	
何も	なにも	nothing (with neg. verb)	
ゴールド	ゴールド	gold	
体	からだ	body; health	
飲み物	のみもの	drink; beverage	
ジーンズ	ジーンズ	jeans	
一日	ついたち	(arch) first day of the month; first ten days of the lunar month	
楽しむ	たのしむ	to enjoy oneself	
ピザ	ピザ	pizza	
毎年	まいとし, まいねん	every year	
今日は	こんにちは, こんちは	hello; good day (daytime greeting)	
エレベーター	エレベーター	elevator	
気にしないで	きにしないで	Don't worry about it.	
この	この	this (thing)	
御兄さん	おにいさん	older brother	
ストーブ	ストーブ	heater (derived from the word "stove")	
～週間	～しゅうかん	weeks	
さよなら	さよなら	good-bye; so long	
南	みなみ	south	
思える	おもえる	to seem; to appear likely	
カメラ	カメラ	camera	
気分	きぶん	feeling; mood	
時間を過ごす	じかんをすごす	spend time	
三百	さんびゃく	three hundred	
はじめまして	はじめまして	Nice to meet you. (How do you do?) Literal translation : "this is the first time".	
男の子	おとこのこ	boy; baby boy	
ありがとうございました	ありがとうございました	Thank you very much (said after something is done)	
谷	たに	valley; ravine	
上げる	あげる	to raise; to give; to do for; to elevate	
そうですね	そうですね	That's right.	
あっち	あっち	that place/way/person over there (informal)	
ナイフ	ナイフ	knife	
五万	ごまん	fifty thousand	
三	さん, み	three	
学生	がくせい	student	
時	とき	time; when...	
四才	よんさい	four years old	
スキー	スキー	ski; skiing	
明るい	あかるい	bright; colourful; cheerful; familiar (with)	
コンサート	コンサート	concert	
またね	またね	good-bye; see you later	
二十四日	にじゅうよっか	the twenty-fourth (day)	
下さい	ください	please; give me...	
十二日	じゅうににち	the twelfth (day)	
八百	はっぴゃく	eight hundred	
何人	なんにん	how many people?	
六月	ろくがつ	June	
鍵を掛ける	かぎをかける	lock (a door)	
メール	メール	e-mail	
ポケット	ポケット	pocket	
百	ひゃく	hundred	
しなかった	しなかった	didn't do (plain)	
～時	～じ	o'clock	
未だ	まだ,　いまだ	(not) yet; more; still	
ラジオ	ラジオ	radio	
そう思います	そうおもいます	That is what I think.	
書く	かく	to write; to compose; to pen; to draw; to paint	
オレンジ色	オレンジいろ	orange (colour, color)	
一時	いちじ	one o'clock	
ボタン	ボタン	button	
お金	おかね	money	
青	あお	blue; green; green light; youth	
よく	よく	often	
十才	じゅっさい,じっさい	ten years old	
太る	ふとる	to grow fat; to fatten	
～年	～ねん	years (grade in school; duration; specific year)	
キログラム	キログラム	kilogram	
どうぞよろしく	どうぞよろしく	pleased to meet you	
クレジットカード	クレジットカード	credit card	
お酒	おさけ	sake; alcohol	
晩ご飯	ばんごはん	dinner	
何時まで	いつまで	how long?; till when?	
十ページをみてください	じゅうページをみてください	Please look at page 10.	
山田さん	やまださん	Mr./Mrs. Yamada	
どっち	どっち	which (between two choices); which place/way/person? (informal)	
メニュー	メニュー	menu; bill of fare	
キロメートル	キロメートル	kilometer	
手	て	hand	
彼	かれ	he; one's boyfriend	
三才	さんさい	three years old; the three powers: heaven, earth and man	
じゃ	じゃ	ja (hiragana)	
うん	うん	uh-huh; yes	
来る	くる	to come; to arrive	
テープレコーダー	テープレコーダー	tape recorder; cassette recorder	
アパート	アパート	apartment; flat; apartment house	
カレー	カレー	curry	
十五	じゅうご	fifteen	
五つ	いつつ	five (things)	
九時	くじ	nine o’clock	
バーベキュー	バーベキュー	barbecue	
していません	していません	not doing (polite)	
とか	とか	and so on; for example	
している	している	doing (plain)	
スプーン	スプーン	spoon	
か	か	ka (hiragana)	
～だろう	～だろう	probably (plain)	
しています	しています	doing (polite)	
もしもし	もしもし	Hello? (used on the phone)	
二十一日	にじゅういちにち	the twenty-first (day)	
本屋	ほんや	bookstore; bookshop	
ハンバーガー	ハンバーガー	hamburger	
十九日	じゅうくにち	the nineteenth (day)	
やくざ	やくざ	yakuza; gangster	
うそでしょう	うそでしょう	Are you kidding?; Probably a lie	
ので	ので	that being the case; because of ...; the reason is ....; given that...	
作文	さくぶん	composition; essay	
ポスト	ポスト	mail box; post box	
でした	でした	past tense of です	
かな	かな	I wonder; I guess	
よかった	よかった	What a relief; I'm glad	
十一才	じゅういっさい	eleven years old	
サッカー	サッカー	soccer; football	
一	いち	one	
良く	よく	well; often	
茶色	ちゃいろ	light brown	
～でございます	～でございます	polite form of です	
三月	さんがつ	March	
田	た	rice field; rice paddy	
十一月	じゅういちがつ	November	
だった	だった	plain form of a copula でした	
ケーキ	ケーキ	cake	
テニス	テニス	tennis	
これ、お願いします	これ、おねがいします	Can you take care of this, please?	
パーティー	パーティー	party	
心	こころ	heart; mind	
五月	ごがつ	May	
じゃありません	じゃありません	negative of です (slightly more informal)	
～くて	～くて	conjuctive form of い adjective	
ではない	ではない	slightly more formal version of じゃない	
七つ	ななつ	seven (things)	
スーパー	スーパー	super; supermarket	
グレー	グレー	gray; grey	
あげる	あげる	give; raise; deep-fry	
しません	しません	don't do (polite)	
ですから	ですから	so; therefore; that said	
で	で	de (hiragana)	
十月	じゅうがつ	October	
していませんでした	していませんでした	wasn't doing (polite)	
ではありませんでした	ではありませんでした	negative past tense of です	
この人	このひと	this person	
もっと	もっと	(some) more; even more; longer; further	
チョコレート	チョコレート	chocolate	
英語	えいご	English language	
タクシー	タクシー	taxi; cab	
でしょう	でしょう	probably (polite); right?	
とても	とても	very	
けど	けど	but; however; although	
何時	いつ	when	
～かもしれません	～かもしれません	may; might (polite)	
そうですか	そうですか	I see; Is that so; Really?	
いいえ	いいえ	no	
ズボン	ズボン	trousers; pants	
～と言う	～という	to say that...; called/named...	
じゃあね	じゃあね	See you then; Bye; Ciao	
来ます	きます	to come	
三十日	さんじゅうにち	the thirtieth (day)	
スリッパ	スリッパ	slippers	
バイク	バイク	motorbike; motor cycle	
二分	にふん	two minutes	
買い物	かいもの	shopping; purchased goods	
～キロ	～キロ	kilo (kilogram or kilometer)	
ドライブ	ドライブ	drive	
か	か	question particle; or	
何か	なにか	something; some	
が	が	ga (hiragana)	
分かりましたか	わかりましたか	Do you understand (it)?	
十五日	じゅうごにち	the fifteenth (day)	
と	と	to (hiragana)	
レポート	レポート	report; paper	
ペット	ペット	pet	
ではありません	ではありません	negative of です	
です	です	be (copula)	
クラブ	クラブ	club	
アメリカ	アメリカ	America; the US	
まだです	まだです	not yet	
どうしよう	どうしよう	What should I/we do?	
パン	パン	bread	
します	します	do (polite)	
テスト	テスト	test; exam	
ジャケット	ジャケット	jacket	
一万	いちまん	ten thousand	
コンピューター	コンピューター	computer	
私	わたし,わたくし	I; me	
十八日	じゅうはちにち	the eighteenth (day)	
～かもしれない	～かもしれない	may; might (plain)	
こっち	こっち	this place/way/person here (informal)	
四分	よんぷん	four minutes	
じゃなかった	じゃなかった	plain version of ではありませんでした	
二十六日	にじゅうろくにち	the twenty-sixth (day)	
グリーン	グリーン	green	
歌う	うたう	to sing	
ビジネス	ビジネス	business	
私も	わたしも	So do I.	
二十二日	にじゅうににち	the twenty-second (day)	
ボールペン	ボールペン	ballpoint pen	
それから	それから	afterwards; and then	
食べ物	たべもの	food	
ビール	ビール	beer; lager	
何ですか	なんですか	What is it?	
毎日	まいにち	every day	
四百	よんひゃく	four hundred	
おめでとうございます	おめでとうございます	Congratulations!	
五分	ごふん	five minutes	
や	や	ya (hiragana)	
習う	ならう	to learn; practice	
サークル	サークル	circle; circle (group of like-minded people)	
こんな～	こんな～	...like this; this kind of...	
～けど	～けど	...but; ...so	
九千	きゅうせん	nine thousand	
クリスマス	クリスマス	Christmas	
しませんでした	しませんでした	didn't do (polite)	
言う	いう	to say	
していない	していない	not doing (plain)	
日曜日	にちようび	Sunday	
～語	～ご	language	
十三日	じゅうさんにち	the thirteenth (day)	
買う	かう	to buy	
三十一日	さんじゅういちにち	the thirty-first (day)	
二月	にがつ	February	
ニュース	ニュース	news	
ゴルフ	ゴルフ	golf	
ギター	ギター	guitar	
サーフィン	サーフィン	surfing	
お早うございます	おはようございます	good morning	
入口	いりぐち	entrance; gate	
ええと	ええと	well...; let me see...	
二	に	two	
次は～		next (stop)...	
ね	ね	ne (hiragana)	
クラス	クラス	class	
あれ	あれ	that (distant from speaker and listener)	
にする	にする	decide on (an item or course of action)	
その	その	that (thing)	
七万	ななまん	seventy thousand	
コンビニ	コンビニ	convenience store	
三千	さんぜん	three thousand	
わかりました	わかりました	I understand.	
三年生	さんねんせい	third-year student	
～人	～にん	counter for people	
出来る	できる	to be able to do; to be good at	
西口	にしぐち	west entrance	
千	せん, ち	thousand	
テープ	テープ	tape; cassette	
二十五日	にじゅうごにち	the twenty-fifth (day)	
十二月	じゅうにがつ	December	
二万	にまん	twenty thousand	
ください	ください	please give me ...; please ... (suffix)	
ゲーム	ゲーム	game	
六万	ろくまん	sixty thousand	
じゃない	じゃない	plain form of ではありません	
父	ちち	father	
中	なか	inside; middle; center; among	
どの	どの	which (thing)	
話す	はなす	to talk; to speak; to converse; to chat	
わかりません	わかりません	(I) don't understand	
など	など	et cetera, and the like, and so forth	
八月	はちがつ	August	
な	な	na (hiragana)	
七月	しちがつ	July	
三万	さんまん	thirty thousand	
大学生	だいがくせい	university student	
何時でも	いつでも	any time; whenever	
こんばんは	こんばんは	Good evening.; Hello.	
シャンプー	シャンプー	shampoo	
三十分	さんじゅっぷん,さんじっぷん	thirty minutes	
人々	ひとびと	each person; people; men and women; everybody	
二千	にせん	two thousand	
十九	じゅうきゅう,じゅうく	nineteen	
九月	くがつ	September	
さようなら	さようなら	Good-bye	
オーストラリア	オーストラリア	Australia	
こんにちは	こんにちは	Good afternoon.; Hello.	
ページ	ページ	page	
トイレ	トイレ	toilet	
五千	ごせん	five thousand	
思う	おもう	to think	
朝	あさ	morning	
其れ	それ	that; that one	
九万	きゅうまん	ninety thousand	
月曜日	げつようび	Monday	
おはよう	おはよう	Good morning. (informal)	
いい子	いいこ	good child	
やっぱり	やっぱり	just as I thought; after all	
レストラン	レストラン	restaurant	
ネクタイ	ネクタイ	tie; necktie	
見える	みえる	to be visible; to seem	
さん	さん	Mr./Ms....	
十	とお	ten (things)	
に	に	ni (hiragana)	
三十	さんじゅう	thirty	
六千	ろくせん	six thousand	
カーテン	カーテン	curtain	
も	も	mo (hiragana)	
カラオケ	カラオケ	karaoke	
～年生	～ねんせい	... year student	
イギリス	イギリス	Britain	
外国人	がいこくじん	foreigner	
はい	はい	yes; okay	
パソコン	パソコン	personal computer	
羽	ウ, は, はね	feathers; counter for birds, rabbits	
米	メートル	meter; gauge	
そうです	そうです	That's right.	
大き	おおき	big; large	
語	ご	language (suffix); word; term	
フォーク	フォーク	fork	
スウェーデン	スウェーデン	Sweden	
どう	どう	how; in what way; how about	
おやすみなさい	おやすみなさい	Good night.	
だ	だ	da (hiragana)	
食べる	たべる	to eat	
～本	～ほん	counter for long, thin objects (bottles, pencils, films, etc.)	
四十	よんじゅう	forty	
大きい	おおきい	big	
ゼロ	ゼロ	zero	
～円	～えん	yen	
ありがとう	ありがとう	thank you	
物	もの	thing; object	
六	ろく	six	
ホテル	ホテル	hotel	
でも	でも	but; however	
七千	ななせん	seven thousand	
一	イチ, イツ, ひと, ひと.つ	one; one radical (no.　1)	
スポーツ	スポーツ	sport	
